一	ggll
丁	sgh
丂	gnv
七	agn
丄	hgd
丅	ghk
丆	dgt
万	dnv
丈	dyi
三	dggg
上	hhgg
下	ghi
丌	gjk
不	gii
与	gngd
丏	ghnn
丐	ghnv
丑	nfd
丒	vygf
专	fnyi
且	egd
丕	gigf
世	anv
丗	gkgd
丘	rgd
丙	gmwi
业	ogd
丛	wwgf
东	aii
丝	xxgf
丞	bigf
丟	gcu
丠	uxgf
両	gmmk
丢	tfcu
丣	gajn
两	gmww
严	godr
並	uogf
丧	fueu
丨	hhll
丩	nhk
个	whj
丫	uhk
丬	uygh
中	khk
丮	nfhk
丯	ehk
丰	dhk
丱	njhg
串	kkhk
丳	kkjk
临	jtyj
丵	oguf
丶	yyll
丷	uyt
丸	vyi
丹	myd
为	ylyi
主	ygd
丼	fjyi
丽	gmyy
举	iwfh
丿	ttll
乀	yyll
乁	yyll
乂	qty
乃	etn
乄	nyi
久	qyi
乆	nwi
乇	tav
么	tcu
义	yqi
乊	tur
之	pppp
乌	qngd
乍	thfd
乎	tuhk
乏	tpi
乐	qii
乑	tii
乒	rgtr
乓	rgyu
乔	tdjj
乕	rfmh
乖	tfux
乗	tgas
乘	tuxv
乙	nnll
乚	nnll
乛	nnll
乜	nnv
九	vtn
乞	tnb
也	bnhn
习	nud
乡	xte
乢	mnn
乣	xnn
乤	ghnb
乥	tunb
书	nnhy
乧	ufnb
乨	cknn
乩	hknn
乪	nld
乫	lknb
乬	annb
乭	dnb
乮	qtbn
乯	tuhn
买	nudu
乱	tdnn
乲	uqwn
乳	ebnn
乴	rrnb
乵	unn
乶	gehn
乷	iitn
乸	bxgu
乹	fjnn
乺	rnrn
乻	ywun
乼	iygn
乽	ftjn
乾	fjtn
乿	exin
亀	qjjn
亁	fjfn
亂	ecmn
亃	oqan
亄	fpgn
亅	hhll
了	bnh
亇	qhj
予	cbj
争	qvhj
亊	guvh
事	gkvh
二	fgg
亍	fhk
于	gfk
亏	fnv
亐	fnv
云	fcu
互	gxgd
亓	fjj
五	gghg
井	fjk
亖	fff
亗	mff
亘	gjgf
亙	ghng
亚	gogd
些	hxff
亜	gkjg
亝	cccf
亞	gfgd
亟	bkcg
亠	yyg
亡	ynv
亢	ymb
亣	yjj
交	uqu
亥	yntw
亦	you
产	ute
亨	ybj
亩	ylf
亪	yoyu
享	ybf
京	yiu
亭	ypsj
亮	ypmb
亯	yjf
亰	yjiu
亱	ywjg
亲	usu
亳	ypta
亴	ypfv
亵	yrve
亶	ylkg
亷	utvo
亸	ybuf
亹	ywfg
人	wwww
亻	wth
亼	wgf
亽	wyu
亾	wnv
亿	wnn
什	wfh
仁	wfg
仂	wln
仃	wsh
仄	dwi
仅	wcy
仆	why
仇	wvn
仈	wwy
仉	wmn
今	wynb
介	wjj
仌	wwu
仍	wen
从	wwy
仏	wcy
仐	wfj
仑	wxb
仒	wuu
仓	wbb
仔	wbg
仕	wfg
他	wbn
仗	wdyy
付	wfy
仙	wmh
仚	wmj
仛	wtan
仜	wag
仝	waf
仞	wvyy
仟	wtfh
仠	wfh
仡	wtnn
仢	wqyy
代	way
令	wycu
以	nywy
仦	wiy
仧	hwu
仨	wdg
仩	whg
仪	wyqy
仫	wtcy
们	wun
仭	wvyy
仮	wrcy
仯	witt
仰	wqbh
仱	wwyn
仲	wkhh
仳	wxxn
仴	weg
仵	wtfh
件	wrhh
价	wwjh
仸	wtdy
仹	wdhh
仺	wagf
任	wtfg
仼	wgg
份	wwvn
仾	wgxg
仿	wyn
伀	wwcy
企	whf
伂	wgmh
伃	wcbh
伄	wxhh
伅	wgbn
伆	wqrt
伇	wmcy
伈	wny
伉	wymn
伊	wvtt
伋	weyy
伌	wdbn
伍	wgg
伎	wfcy
伏	wdy
伐	wat
休	wsy
伒	wrh
伓	wgiy
伔	wpmn
伕	wfwy
伖	wdcy
众	wwwu
优	wdnn
伙	woy
会	wfcu
伛	waqy
伜	wvfh
伝	wfcy
伞	wuhj
伟	wfnh
传	wfny
伡	wlh
伢	waht
伣	wmqn
伤	wtln
伥	wtay
伦	wwxn
伧	wwbn
伨	wqug
伩	wyy
伪	wyly
伫	wpgg
伬	wnyy
伭	wyxy
伮	wvcy
伯	wrg
估	wdg
伱	wwiy
伲	wnxn
伳	trff
伴	wufh
伵	wlg
伶	wwyc
伷	wmg
伸	wjhh
伹	wegg
伺	wngk
伻	wguh
似	wnyw
伽	wlkg
伾	wgig
伿	wkwy
佀	wnhn
佁	wckg
佂	wghg
佃	wlg
佄	wafg
佅	wfiy
但	wjgg
佇	wpsh
佈	wdmh
佉	wfcy
佊	whcy
佋	wvkg
佌	whxn
位	wug
低	wqay
住	wygg
佐	wdag
佑	wdkg
佒	wmdy
体	wsgg
佔	whkg
何	wskg
佖	wntt
佗	wpxn
佘	wfiu
余	wtu
佚	wrwy
佛	wxjh
作	wthf
佝	wqkg
佞	wfvg
佟	wtuy
你	wqiy
佡	wwmh
佢	wang
佣	weh
佤	wgnn
佥	wgif
佦	wdg
佧	whhy
佨	wqnn
佩	wmgh
佪	wlkg
佫	wtkg
佬	wftx
佭	wtah
佮	wwgk
佯	wudh
佰	wdjg
佱	wfhf
佲	wqkg
佳	wffg
佴	wbg
併	wuah
佶	wfkg
佷	wvey
佸	wtdg
佹	wqdb
佺	wwgg
佻	wiqn
佼	wuqy
佽	wuqw
佾	wweg
使	wgkq
侀	wgaj
侁	wtfq
侂	wyta
侃	wkqn
侄	wgcf
侅	wynw
來	swwi
侇	wgxw
侈	wqqy
侉	wdfn
侊	wiqn
例	wgqj
侌	wync
侍	wffy
侎	woy
侏	wriy
侐	wtlg
侑	wdeg
侒	wpvg
侓	wvfh
侔	wcrh
侕	wdmj
侖	wgma
侗	wmgk
侘	wpta
侙	waag
侚	wqjg
供	wawy
侜	wtey
依	wyey
侞	wvkg
侟	wdhb
侠	wguw
価	wsg
侢	wgmf
侣	wkkg
侤	wftn
侥	watq
侦	whmy
侧	wmjh
侨	wtdj
侩	wwfc
侪	wyjh
侫	wynv
侬	wpey
侭	wnyu
侮	wtxu
侯	wntd
侰	wvtk
侱	wkgg
侲	wdfe
侳	wwwf
侴	wgnj
侵	wvpc
侶	wktk
侷	wnnk
侸	wgku
侹	wtfp
侺	wmwn
侻	wukq
侼	wfpb
侽	wlln
侾	wftb
便	wgjq
俀	wevg
俁	wknd
係	wtxi
促	wkhy
俄	wtrt
俅	wfiy
俆	wwty
俇	wqtg
俈	wtfk
俉	wgkg
俊	wcwt
俋	wkcn
俌	wgey
俍	wyve
俎	wweg
俏	wieg
俐	wtjh
俑	wceh
俒	wpfq
俓	wgva
俔	whqn
俕	wpsy
俖	wgik
俗	wwwk
俘	webg
俙	wqdh
俚	wjfg
俛	wqkq
俜	wmgn
保	wksy
俞	wgej
俟	wctd
俠	wdww
信	wyg
俢	wtet
俣	wkgd
俤	wuxt
俥	wlh
俦	wdtf
俧	wfny
俨	wgod
俩	wgmw
俪	wgmy
俫	wgoy
俬	wtcy
俭	wwgi
修	whte
俯	wywf
俰	wtkg
俱	whwy
俲	wuql
俳	wdjd
俴	waat
俵	wgey
俶	whic
俷	wecn
俸	wdwh
俹	wgfg
俺	wdjn
俻	wtlg
俼	wyce
俽	wrqw
俾	wrtf
俿	wham
倀	wdey
倁	wtdk
倂	wtff
倃	wthk
倄	wqde
倅	wywf
倆	wgmy
倇	wpqb
倈	wsww
倉	wyvk
倊	wwcn
個	wldg
倌	wpnn
倍	wukg
倎	wmaw
倏	whtd
倐	whto
們	wug
倒	wgcj
倓	wooy
倔	wnbm
倕	wtgf
倖	wfuf
倗	weeg
倘	wimk
候	whnd
倚	wdsk
倛	wadw
倜	wmfk
倝	fjwy
倞	wyiy
借	wajg
倠	wwyg
倡	wjjg
倢	wgvh
倣	wyty
値	wfhn
倥	wpwa
倦	wudb
倧	wpfi
倨	wndg
倩	wgeg
倪	wvqn
倫	wwga
倬	whjh
倭	wtvg
倮	wjsy
倯	wswc
倰	wfwt
倱	wjxx
倲	wgji
倳	wgkh
倴	wdfa
倵	wgah
倶	whgw
倷	wdfi
倸	wesy
倹	wwgw
债	wgmy
倻	wbbh
值	wfhg
倽	wwfk
倾	wxdm
倿	wuvg
偀	wamd
偁	wemf
偂	wuej
偃	wajv
偄	wdmd
偅	wtgf
偆	wdwj
假	wnhc
偈	wjqn
偉	wnhh
偊	wtky
偋	wnua
偌	wadk
偍	wjgh
偎	wlge
偏	wyna
偐	wute
偑	wmtj
偒	wjgr
偓	wngf
偔	wkkn
偕	wxxr
偖	wftj
偗	with
偘	wkkk
偙	wuph
做	wdty
偛	wtfv
停	wyps
偝	wuxe
偞	wans
偟	wrgg
偠	wsvg
偡	wadn
偢	wtoy
偣	wujg
偤	wusg
健	wvfp
偦	wnhe
偧	wdqq
偨	whxs
偩	wqmy
偪	wgkl
偫	wtff
偬	wqrn
偭	wdmd
偮	wkbg
偯	wyey
偰	wdhd
偱	wrfh
偲	wlny
偳	wmdj
側	wmjh
偵	whmy
偶	wjmy
偷	wwgj
偸	wwgb
偹	whtl
偺	wthj
偻	wovg
偼	whvh
偽	wyto
偾	wfam
偿	wipc
傀	wrqc
傁	wvhc
傂	wrhm
傃	wgxi
傄	wduh
傅	wgef
傆	wdri
傇	wabg
傈	wssy
傉	wdff
傊	wkmy
傋	wfjf
傌	wcy
傍	wupy
傎	wfhw
傏	wyvk
傐	wymk
傑	wqas
傒	wexd
傓	wynn
傔	wuvo
傕	wpwy
傖	wwyk
傗	wyxl
傘	wwwf
備	wate
傚	wuqt
傛	wpwk
傜	werm
傝	wjng
傞	wuda
傟	wwcn
傠	wyfy
傡	wuug
傢	wpey
傣	wdwi
傤	wfal
傥	wipq
傦	wmeg
傧	wprw
储	wyfj
傩	wcwy
傪	wcce
傫	wlxi
催	wmwy
傭	wyvh
傮	wgmj
傯	wtln
傰	wmee
傱	wtwh
傲	wgqt
傳	wgjf
傴	wakk
債	wgmy
傶	wdht
傷	wtjr
傸	wdqq
傹	wujq
傺	wwfi
傻	wtlt
傼	wakw
傽	wujh
傾	wxdm
傿	wgho
僀	waqh
僁	wton
僂	wlvg
僃	waqe
僄	wsfi
僅	wakg
僆	wlpy
僇	wnwe
僈	wjlc
僉	wgkw
僊	wsdn
僋	wwym
僌	wlty
働	wtgl
僎	wnnw
像	wqje
僐	wudk
僑	wtdk
僒	wpwk
僓	wkhm
僔	wusf
僕	wogy
僖	wfkk
僗	wool
僘	wimt
僙	wamw
僚	wdui
僛	wadw
僜	wwgu
僝	wnbb
僞	weto
僟	wxxt
僠	wtol
僡	wgjn
僢	weph
僣	wfwj
僤	wkkf
僥	wffq
僦	wyin
僧	wulj
僨	wfam
僩	wueg
僪	wcbk
僫	wgfn
僬	wwyo
僭	waqj
僮	wujf
僯	woqh
僰	gmiw
僱	wyny
僲	wsqh
僳	wsoy
僴	wujg
僵	wglg
僶	wxg
僷	waas
僸	wssi
價	wsmy
僺	wkks
僻	wnku
僼	wmau
僽	wton
僾	wept
僿	wpff
儀	wugt
儁	wwym
儂	wmae
儃	wylg
億	wujn
儅	wipl
儆	waqt
儇	wlge
儈	wwgj
儉	wwgw
儊	wssh
儋	wqdy
儌	wryt
儍	wqot
儎	wfal
儏	whqo
儐	wpgm
儑	wjxo
儒	wfdj
儓	wfkf
儔	wfnf
儕	wyjg
儖	wahl
儗	wxth
儘	wvhl
儙	wkhp
儚	walq
儛	wrlh
儜	wpns
儝	woos
儞	wgwq
償	wipm
儠	wvln
儡	wlll
儢	whan
儣	wyaw
儤	wjai
儥	wflm
儦	wyno
儧	wfwm
儨	wrrm
儩	wmjr
優	wdet
儫	wype
儬	wgeq
儭	wusq
儮	wdth
儯	wudc
儰	waeo
儱	wued
儲	wyfj
儳	wqky
儴	wyke
儵	whto
儶	wmwk
儷	wgmx
儸	wlxy
儹	wtfm
儺	waky
儻	wipo
儼	wkkt
儽	wlli
儾	wgke
儿	qtn
兀	gqv
允	cqb
兂	aqv
元	fqb
兄	kqb
充	ycqb
兆	iqv
兇	qbqb
先	tfqb
光	iqb
兊	wcqb
克	dqb
兌	wkqb
免	qkqb
兎	tkqy
兏	dhqv
児	hjqb
兑	ukqb
兒	vqb
兓	aqaq
兔	qkqy
兕	mmgq
兖	ucqb
兗	ukqb
兘	fqck
兙	dqfk
党	ipkq
兛	dqtf
兜	qrnq
兝	dqwv
兞	dqtn
兟	tfqq
兠	urxq
兡	dqdj
兢	dqdq
兣	dqdf
兤	iqyw
入	tyi
兦	tynv
內	mtyi
全	wgf
兩	gmhy
兪	wgeb
八	wty
公	wcu
六	uygy
兮	wgnb
兯	ubj
兰	uff
共	awu
兲	gwu
关	udu
兴	iwu
兵	rgwu
其	adwu
具	hwu
典	mawu
兹	uxxu
兺	wvkx
养	udyj
兼	uvou
兽	ulgk
兾	ulaw
兿	urvc
冀	uxlw
冁	ujfe
冂	mhn
冃	mfd
冄	mfd
内	mwi
円	mhgd
冇	dmb
冈	mqi
冉	mfd
冊	mak
冋	mkd
册	mmgd
再	gmfd
冎	mnmb
冏	mwkd
冐	jef
冑	mef
冒	jhf
冓	fjgf
冔	jkgf
冕	jqkq
冖	pyn
冗	pmb
冘	pqv
写	pgng
冚	pmj
军	plj
农	pei
冝	pegf
冞	pou
冟	prxb
冠	pfqf
冡	pgeu
冢	peyu
冣	pbcu
冤	pqky
冥	pjuu
冦	pfqc
冧	pssu
冨	pgkl
冩	pvqo
冪	pajh
冫	uyg
冬	tuu
冭	duu
冮	uag
冯	ucg
冰	uiy
冱	ugxg
冲	ukhh
决	unwy
冴	uaht
况	ukqn
冶	uckg
冷	uwyc
冸	uufh
冹	udcy
冺	unan
冻	uaiy
冼	utfq
冽	ugqj
冾	uwgk
冿	uvfh
净	uqvh
凁	ugki
凂	uqkq
凃	uwty
凄	ugvv
凅	uldg
准	uwyg
凇	uswc
凈	uevh
凉	uyiy
凊	ugeg
凋	umfk
凌	ufwt
凍	ugji
凎	uqg
减	udgt
凐	usfg
凑	udwd
凒	umgu
凓	ussy
凔	uwyk
凕	upju
凖	uwyf
凗	umwy
凘	uadr
凙	ulff
凚	ussi
凛	uyli
凜	uylt
凝	uxth
凞	utao
凟	uflm
几	mtn
凡	myi
凢	tmv
凣	hmv
凤	mci
凥	nmv
処	tmv
凧	mmhk
凨	mfci
凩	msi
凪	mhd
凫	qynm
凬	mgjd
凭	wtfm
凮	mdjd
凯	mnmn
凰	mrgd
凱	mgkm
凲	muvo
凳	wgkm
凴	ucmb
凵	bnh
凶	qbk
凷	fbk
凸	hgmg
凹	mmgd
出	bmk
击	fmk
凼	ibk
函	bibk
凾	bkcb
凿	ogub
刀	vnt
刁	ngd
刂	jhh
刃	vyi
刄	vyi
刅	vwi
分	wvb
切	avn
刈	qjh
刉	tnjh
刊	fjh
刋	tdjh
刌	fjh
刍	qvf
刎	qrjh
刏	rnjh
刐	myjh
刑	gajh
划	ajh
刓	fqjh
刔	nwjh
刕	vvvb
刖	ejh
列	gqjh
刘	yjh
则	mjh
刚	mqjh
创	wbjh
刜	xjjh
初	puvn
刞	egjh
刟	vkjh
删	mmgj
刡	najh
刢	wycj
刣	ckjh
判	udjh
別	kqjh
刦	fcjh
刧	fcvn
刨	qnjh
利	tjh
刪	majh
别	kljh
刬	gjh
刭	cajh
刮	tdjh
刯	gjgj
到	gcfj
刱	fjvw
刲	ffjh
刳	dfnj
刴	esjh
刵	bjh
制	rmhj
刷	nmhj
券	udvb
刹	qsjh
刺	gmij
刻	yntj
刼	fcvy
刽	wfcj
刾	guwj
刿	mqjh
剀	mnjh
剁	msjh
剂	yjjh
剃	uxhj
剄	gvaj
剅	gkuj
剆	yvcj
則	mjh
剈	kejh
剉	wwfj
削	iejh
剋	dqjk
剌	gkij
前	uejj
剎	qsyj
剏	uavy
剐	kmwj
剑	wgij
剒	ajjh
剓	tqtv
剔	jqrj
剕	djdj
剖	ukjh
剗	aajh
剘	adwj
剙	uavw
剚	gkvj
剛	mumj
剜	pqbj
剝	xgij
剞	dskj
剟	cccj
剠	yijh
剡	oojh
剢	eyjh
剣	wgkj
剤	yjjh
剥	vijh
剦	djnj
剧	ndjh
剨	dhdj
剩	tuxj
剪	uejv
剫	yacj
剬	mdmj
剭	ngcj
剮	mnmj
副	gklj
剰	tgaj
剱	wgky
割	pdhj
剳	awgj
剴	mgkj
創	wyvj
剶	xejh
剷	uttj
剸	gjhj
剹	nwej
剺	fitv
剻	meej
剼	cccj
剽	sfij
剾	akkj
剿	vjsj
劀	cbtj
劁	wyoj
劂	dubj
劃	vflj
劄	twgj
劅	lqjj
劆	yuvj
劇	haej
劈	nkuv
劉	qyvj
劊	wglj
劋	kkkj
劌	hdgj
劍	wgkj
劎	wgkv
劏	ipkj
劐	awyj
劑	yjjh
劒	wgky
劓	thlj
劔	wgky
劕	rrmj
劖	qkxj
劗	tfqj
劘	yssj
劙	xejj
劚	nilj
力	ltn
劜	lnn
劝	cln
办	lwi
功	aln
加	lkg
务	tlb
劢	dnln
劣	itlb
劤	rln
劥	ymln
劦	lllb
劧	rln
动	fcln
助	egln
努	vclb
劫	fcln
劬	qkln
劭	vkln
劮	rwln
劯	dln
劰	rln
励	ddnl
劲	caln
劳	aplb
労	iplb
劵	udlb
劶	rgkl
劷	udln
劸	ffln
効	uqln
劺	crhl
劻	agln
劼	fkln
劽	gqjl
劾	yntl
势	rvyl
勀	dqln
勁	gval
勂	tfkl
勃	fpbl
勄	txgl
勅	gkil
勆	yvcl
勇	celb
勈	celn
勉	qkql
勊	dqlv
勋	kmln
勌	udbl
勍	yiln
勎	fwfl
勏	ukln
勐	blln
勑	swwl
勒	afln
勓	xxrl
勔	dmjl
動	tgjl
勖	jhln
勗	jegl
勘	adwl
務	cbtl
勚	anml
勛	kmln
勜	wcnl
勝	eudl
勞	oopl
募	ajdl
勠	nwel
勡	sfil
勢	fwfl
勣	gmln
勤	akgl
勥	xkjl
勦	vjsl
勧	tdhl
勨	qjel
勩	anml
勪	tdkl
勫	toll
勬	udxl
勭	ujfl
勮	hael
勯	ylkl
勰	llln
勱	ajml
勲	tgjo
勳	tgll
勴	hall
勵	dajl
勶	tycl
勷	ykkl
勸	akkl
勹	qtn
勺	qyi
勻	qfd
勼	qvv
勽	qwi
勾	qci
勿	qre
匀	qud
匁	qqi
匂	qxv
匃	qwnv
匄	qynv
包	qnv
匆	qryi
匇	qqi
匈	qqbk
匉	qguh
匊	qoi
匋	qrmk
匌	qwgk
匍	qgey
匎	qdjn
匏	dfnn
匐	qgkl
匑	qtmx
匒	qawk
匓	qvcc
匔	qtmk
匕	xtn
化	wxn
北	uxn
匘	xvtq
匙	jghx
匚	agn
匛	aqyi
匜	abv
匝	amhk
匞	aad
匟	aymv
匠	ark
匡	agd
匢	aqre
匣	alk
匤	agyi
匥	acak
匦	alvv
匧	adww
匨	anhf
匩	abhg
匪	adjd
匫	aqrj
匬	awgj
匭	alvv
匮	akhm
匯	aiwy
匰	akkf
匱	akhm
匲	adkk
匳	awgw
匴	atha
匵	aflm
匶	aawv
匷	ahhy
匸	agn
匹	aqv
区	aqi
医	atdi
匼	awgk
匽	ajvd
匾	ayna
匿	aadk
區	akkk
十	fgh
卂	nfk
千	tfk
卄	aghh
卅	gkk
卆	vfj
升	tak
午	tfj
卉	faj
半	ufk
卋	faf
卌	glk
卍	nhgh
华	wxfj
协	flwy
卐	nghg
卑	rtfj
卒	ywwf
卓	hjj
協	flll
单	ujfj
卖	fnud
南	fmuf
単	ijfj
卙	adwf
博	fgef
卛	xyxf
卜	hhy
卝	gjgd
卞	yhu
卟	khy
占	hkf
卡	hhu
卢	hne
卣	hlnf
卤	hlqi
卥	hlry
卦	ffhy
卧	ahnh
卨	hmnk
卩	bnh
卪	byi
卫	bgd
卬	qbh
卭	abh
卮	rgbv
卯	qtbh
印	qgbh
危	qdbb
卲	vkbh
即	vcbh
却	fcbh
卵	lhng
卶	qqbh
卷	udbb
卸	rhbh
卹	tlbh
卺	bigb
卻	wwkb
卼	gqqb
卽	rxbh
卾	kkfb
卿	qtvb
厀	swib
厁	wtub
厂	dgt
厃	qdr
厄	dbv
厅	dsk
历	dlv
厇	dtav
厈	dfk
厉	ddnv
厊	daht
压	dfyi
厌	ddi
厍	dlk
厎	dqay
厏	dthf
厐	ddxv
厑	dkxv
厒	drmk
厓	dffd
厔	dgcf
厕	dmjk
厖	ddne
厗	duk
厘	djfd
厙	dlk
厚	djbd
厛	dkrk
厜	dtgf
厝	dajd
厞	ddjd
原	drii
厠	dmjk
厡	drii
厢	dshd
厣	ddlk
厤	dtti
厥	dubw
厦	ddht
厧	dfhw
厨	dgkf
厩	dvcq
厪	dakg
厫	dgqt
厬	djtk
厭	djed
厮	dadr
厯	dssn
厰	dimt
厱	dwgw
厲	dajy
厳	idnt
厴	djel
厵	drii
厶	cny
厷	dcu
厸	ccy
厹	vcu
厺	dcu
去	fcu
厼	ciu
厽	cccu
厾	nfci
县	egcu
叀	gmcu
叁	cddf
参	cder
參	ccce
叄	cccd
叅	cccn
叆	fcec
叇	fcvp
又	cccc
叉	cyi
及	eyi
友	dcu
双	ccy
反	rci
収	nhcy
叏	nhcu
叐	tdcu
发	ntcy
叒	cccu
叓	gkhc
叔	hicy
叕	cccc
取	bcy
受	epcu
变	yocu
叙	wtcy
叚	nhfc
叛	udrc
叜	pocu
叝	fcbc
叞	nfic
叟	vhcu
叠	cccg
叡	hpgc
叢	oguc
口	kkkk
古	dghg
句	qkd
另	klb
叧	kvb
叨	kvn
叩	kbh
只	kwu
叫	knhh
召	vkf
叭	kwy
叮	ksh
可	skd
台	ckf
叱	kxn
史	kqi
右	dkf
叴	vkf
叵	akd
叶	kfh
号	kgnb
司	ngkd
叹	kcy
叺	ktyy
叻	kln
叼	kngg
叽	kmn
叾	bkf
叿	kag
吀	ktfh
吁	kgfh
吂	ynkf
吃	ktnn
各	tkf
吅	kkg
吆	kxy
吇	kbg
合	wgkf
吉	fkf
吊	kmhj
吋	kfy
同	mgkd
名	qkf
后	rgkd
吏	gkqi
吐	kfg
向	tmkd
吒	ktan
吓	kghy
吔	kbn
吕	kkf
吖	kuhh
吗	kcg
吘	ktfh
吙	koy
吚	kvtt
君	vtkd
吜	knfg
吝	ykf
吞	gdkf
吟	kwyn
吠	kdy
吡	kxxn
吢	nkf
吣	kny
吤	kwjh
吥	kgiy
否	gikf
吧	kcn
吨	kgbn
吩	kwvn
吪	kwxn
含	wynk
听	krh
吭	kymn
吮	kcqn
启	ynkd
吰	kdcy
吱	kfcy
吲	kxhh
吳	kndu
吴	kgdu
吵	kitt
吶	kmty
吷	knwy
吸	keyy
吹	kqwy
吺	kmcy
吻	kqrt
吼	kbnn
吽	krhh
吾	gkf
吿	rhkf
呀	kaht
呁	kqug
呂	ktkf
呃	kdbn
呄	edf
呅	kyy
呆	ksu
呇	ikf
呈	kgf
呉	kngw
告	tfkf
呋	kfwy
呌	kufh
呍	kfcy
呎	knyy
呏	ktah
呐	kmwy
呑	tdkf
呒	kfqn
呓	kann
呔	kdyy
呕	kaqy
呖	kdln
呗	kmy
员	kmu
呙	kmwu
呚	kty
呛	kwbn
呜	kqng
呝	kynn
呞	kngk
呟	kyxy
呠	ksgg
呡	knan
呢	knxn
呣	kxgu
呤	kwyc
呥	kmfg
呦	kxln
呧	kqay
周	mfkd
呩	kfiy
呪	kkqn
呫	khkg
呬	klg
呭	kann
呮	kkwy
呯	kguh
呰	hxkf
呱	krcy
呲	khxn
味	kfiy
呴	kqkg
呵	kskg
呶	kvcy
呷	klh
呸	kgig
呹	krwy
呺	kkgn
呻	kjhh
呼	ktuh
命	wgkb
呾	kjgg
呿	kfcy
咀	kegg
咁	kafg
咂	kamh
咃	kwbn
咄	kbmh
咅	ukf
咆	kqnn
咇	kntt
咈	kxjh
咉	kmdy
咊	kty
咋	kthf
和	tkg
咍	kckg
咎	thkf
咏	kyni
咐	kwfy
咑	krsh
咒	kkmb
咓	kgnn
咔	khhy
咕	kdg
咖	klkg
咗	kdag
咘	kdmh
咙	kdxn
咚	ktuy
咛	kpsh
咜	kpxn
咝	kxxg
咞	kgah
咟	kdjg
咠	kbf
咡	kbg
咢	kkfn
咣	kiqn
咤	kpta
咥	kgcf
咦	kgxw
咧	kgqj
咨	uqwk
咩	kudh
咪	koy
咫	nykw
咬	kuqy
咭	kfkg
咮	kriy
咯	ktkg
咰	kqjg
咱	kthg
咲	kudy
咳	kynw
咴	kdoy
咵	kdfn
咶	ktdg
咷	kiqn
咸	dgkt
咹	kpvg
咺	kgjg
咻	kwsy
咼	mnmk
咽	kldy
咾	kftx
咿	kwvt
哀	yeu
品	kkkf
哂	ksg
哃	kmgk
哄	kawy
哅	kqqb
哆	kqqy
哇	kffg
哈	kwgk
哉	fakd
哊	kdeg
哋	kfbn
哌	krey
响	ktmk
哎	kaqy
哏	kvey
哐	kagg
哑	kgog
哒	kdpy
哓	katq
哔	kxxf
哕	kmqy
哖	ipbf
哗	kwxf
哘	ktfh
哙	kwfc
哚	kmsy
哛	kxwv
哜	kyjh
哝	kpey
哞	kcrh
哟	kxqy
哠	ktfk
員	kmu
哢	kgah
哣	kgku
哤	kdne
哥	sksk
哦	ktrt
哧	kfoy
哨	kieg
哩	kjfg
哪	kvfb
哫	kkhy
哬	kwsk
哭	kkdu
哮	kftb
哯	khqn
哰	kprh
哱	kfpb
哲	rrkf
哳	krrh
哴	kyve
哵	kklj
哶	kgjf
哷	kefy
哸	kevg
哹	kebg
哺	kgey
哻	kjfh
哼	kybh
哽	kgjq
哾	kukq
哿	lksk
唀	kten
唁	kyg
唂	kwwk
唃	kqeh
唄	kmy
唅	kwyk
唆	kcwt
唇	dfek
唈	kkcn
唉	kctd
唊	kdww
唋	kwty
唌	kthp
唍	kpfq
唎	ktjh
唏	kqdh
唐	yvhk
唑	kwwf
唒	ksgg
唓	klh
唔	kgkg
唕	krfh
唖	kgkg
唗	kfhy
唘	dckf
唙	kqto
唚	kvpc
唛	kgty
唜	gskx
唝	kamy
唞	kruf
唟	fckx
唠	kapl
唡	kgmw
唢	kimy
唣	kran
唤	kqmd
唥	kuwc
唦	kiit
唧	kvcb
唨	kbeg
唩	ktvg
唪	kdwh
唫	kqg
唬	kham
唭	kadw
售	wykf
唯	kwyg
唰	knmj
唱	kjjg
唲	kvqn
唳	kynd
唴	kudn
唵	kdjn
唶	kajg
唷	kyce
唸	kwyn
唹	kywu
唺	kmaw
唻	ksww
唼	kuvg
唽	ksrh
唾	ktgf
唿	kqrn
啀	kdff
啁	kmfk
啂	kebn
啃	kheg
啄	keyy
啅	khjh
商	umwk
啇	umdf
啈	kfuf
啉	kssy
啊	kbsk
啋	kesy
啌	kpwa
啍	kybg
啎	tfgk
問	ukd
啐	kywf
啑	kgvh
啒	knbm
啓	yntk
啔	ynak
啕	kqrm
啖	kooy
啗	kqvg
啘	kpqb
啙	hxkk
啚	kflk
啛	kgvv
啜	kccc
啝	ktkg
啞	kgfg
啟	ynkt
啠	rrkf
啡	kdjd
啢	kgmy
啣	krhb
啤	krtf
啥	kwfk
啦	krug
啧	kgmy
啨	kgeg
啩	kffh
啪	krrg
啫	kftj
啬	fulk
啭	klfy
啮	khwb
啯	klgy
啰	klqy
啱	kmdg
啲	krqy
啳	kudb
啴	kujf
啵	kihc
啶	kpgh
啷	kyvb
啸	kvij
啹	kndg
啺	kjgr
啻	upmk
啼	kuph
啽	kwga
啾	ktoy
啿	kadn
喀	kptk
喁	kjmy
喂	klge
喃	kfmf
善	uduk
喅	kjug
喆	fkfk
喇	kgkj
喈	kxxr
喉	kwnd
喊	kdgt
喋	kans
喌	kkyh
喍	khxs
喎	kmnk
喏	kadk
喐	kdeb
喑	kujg
喒	kthj
喓	ksvg
喔	kngf
喕	kdmd
喖	ksdg
喗	kplh
喘	kmdj
喙	kxey
喚	kqmd
喛	kefc
喜	fkuk
喝	kjqn
喞	krxb
喟	kleg
喠	ktgf
喡	knhh
喢	ktfv
喣	kqko
喤	krgg
喥	kyac
喦	kkkm
喧	kpgg
喨	kypm
喩	kwgb
喪	fkke
喫	kdhd
喬	tdkk
喭	kute
單	kkjf
喯	kdfa
喰	kwye
喱	kdjf
喲	kxqy
喳	ksjg
喴	kdgt
喵	kalg
営	ipkk
喷	kfam
喸	gehx
喹	kdff
喺	kwti
喻	kwgj
喼	kqvn
喽	kovg
喾	iptk
喿	kkks
嗀	fpgc
嗁	krhm
嗂	kerm
嗃	kymk
嗄	kdht
嗅	kthd
嗆	kwyk
嗇	fwwk
嗈	kvkc
嗉	kgxi
嗊	kamy
嗋	klle
嗌	kuwl
嗍	kube
嗎	kcy
嗏	kaws
嗐	kpdk
嗑	kfcl
嗒	kawk
嗓	kccs
嗔	kfhw
嗕	kdff
嗖	kvhc
嗗	kmeg
嗘	kexd
嗙	kupy
嗚	kwno
嗛	kuvo
嗜	kftj
嗝	kgkh
嗞	kuxx
嗟	kuda
嗠	ebtk
嗡	kwcn
嗢	kjlg
嗣	kmak
嗤	kbhj
嗥	krdf
嗦	kfpi
嗧	lkwa
嗨	kitu
嗩	kimy
嗪	kdwt
嗫	kbcc
嗬	kawk
嗭	fhkx
嗮	kjsg
嗯	kldn
嗰	kwld
嗱	kwgr
嗲	kwqq
嗳	kepc
嗴	kudc
嗵	kcep
嗶	kjaf
嗷	kgqt
嗸	gqtk
嗹	klpy
嗺	kmwy
嗻	kyao
嗼	kajd
嗽	kgkw
嗾	kytd
嗿	kwym
嘀	kumd
嘁	kdht
嘂	kknk
嘃	kyvh
嘄	kwvs
嘅	gghg
嘆	kakw
嘇	kcce
嘈	kgmj
嘉	fkuk
嘊	kmdf
嘋	kftt
嘌	ksfi
嘍	klvg
嘎	kdha
嘏	dnhc
嘐	knwe
嘑	khah
嘒	kdhv
嘓	klag
嘔	kakk
嘕	kgho
嘖	kgmy
嘗	ipkj
嘘	khag
嘙	kihv
嘚	ktjf
嘛	kyss
嘜	kswt
嘝	kqef
嘞	kafl
嘟	kftb
嘠	kdea
嘡	kipf
嘢	kjfb
嘣	kmee
嘤	kmmv
嘥	kthh
嘦	kwsv
嘧	kpnm
嘨	kvoj
嘩	kagf
嘪	klmy
嘫	kqdo
嘬	kjbc
嘭	kfke
嘮	kool
嘯	kvfj
嘰	kxxt
嘱	knty
嘲	kfje
嘳	kkhm
嘴	khxe
嘵	kffq
嘶	kadr
嘷	kthf
嘸	krlo
嘹	kdui
嘺	ktdk
嘻	kfkk
嘼	kklk
嘽	kkkf
嘾	ksjh
嘿	klfo
噀	knnw
噁	kgfn
噂	kusf
噃	ktol
噄	kdhi
噅	keto
噆	kaqj
噇	kujf
噈	kyin
噉	knbt
噊	kcbk
噋	kybt
噌	kulj
噍	kwyo
噎	kfpu
噏	kwgn
噐	kkak
噑	krif
噒	koqh
噓	khag
噔	kwgu
噕	etnk
噖	kggn
噗	kogy
噘	kduw
噙	kwyc
噚	kvaf
噛	khob
噜	kqgj
噝	kxxi
噞	kwgw
噟	ywwk
噠	kfup
噡	kqdy
噢	ktmd
噣	klqj
噤	kssi
噥	kmae
噦	khdt
噧	kajy
器	kkdk
噩	gkkk
噪	kkks
噫	kujn
噬	ktaw
噭	kryt
噮	klge
噯	kept
噰	kyxy
噱	khae
噲	kwgj
噳	khad
噴	kfam
噵	uthk
噶	kajn
噷	kujw
噸	kgbm
噹	kipl
噺	kusr
噻	kpff
噼	knku
噽	fkug
噾	kpwj
噿	knyf
嚀	kpns
嚁	knwy
嚂	kahl
嚃	klip
嚄	kawc
嚅	kfdj
嚆	kayk
嚇	kfoo
嚈	kdjd
嚉	kogf
嚊	kthj
嚋	kfnf
嚌	kyjg
嚍	kvhl
嚎	kype
嚏	kfph
嚐	kipj
嚑	ktgo
嚒	kysx
嚓	kpwi
嚔	kfph
嚕	kqoj
嚖	kdhn
嚗	kjai
嚘	kdet
嚙	khbh
嚚	kkak
嚛	kxrs
嚜	klff
嚝	kyaw
嚞	fkfk
嚟	ktqi
嚠	kqyj
嚡	kaff
嚢	gkhe
嚣	kkdk
嚤	kysr
嚥	kauo
嚦	kdth
嚧	khal
嚨	kued
嚩	kxgf
嚪	kuqv
嚫	kusq
嚬	khim
嚭	fkuk
嚮	xtyk
嚯	kfwy
嚰	kysd
嚱	khaa
嚲	ybkf
嚳	wfqk
嚴	kkdt
嚵	kqky
嚶	kmmv
嚷	kyke
嚸	klfk
嚹	krmh
嚺	klup
嚻	kkdk
嚼	kelf
嚽	kgqm
嚾	kaky
嚿	kawv
囀	klgf
囁	kbbb
囂	kkdk
囃	kywy
囄	kyby
囅	kkje
囆	kajj
囇	kgmx
囈	kafc
囉	klxy
囊	gkhe
囋	ktfm
囌	kaqt
囍	fkuk
囎	kmuj
囏	akfk
囐	khad
囑	knij
囒	kaui
囓	kdhb
囔	kgke
囕	kahq
囖	ktly
囗	lhng
囘	mnv
囙	lnd
囚	lwi
四	lhng
囜	lci
囝	lbd
回	lkd
囟	tlqi
因	ldi
囡	lvd
团	lfte
団	lfi
囤	lgbn
囥	lymv
囦	lii
囧	lwmv
囨	lgii
囩	lfci
囪	tlry
囫	lqre
囬	mjdd
园	lfqv
囮	lwxv
囯	lgd
困	lsi
囱	tlti
囲	lfjk
図	luqi
围	lfnh
囵	lwxv
囶	lwfd
囷	lti
囸	lghd
囹	lwyc
固	ldd
囻	lnav
囼	lckd
国	lgyi
图	ltui
囿	lded
圀	lwyv
圁	lyd
圂	lei
圃	lgey
圄	lgkd
圅	cluf
圆	lkmi
圇	lwga
圈	ludb
圉	lfuf
圊	lged
國	lakg
圌	lmdj
圍	lnhh
圎	lcmi
圏	ludn
圐	llyv
圑	lgef
園	lfke
圓	lkmi
圔	lfcl
圕	lvfj
圖	lkfk
圗	lcfd
團	lgjf
圙	lwdd
圚	lkhm
圛	llff
圜	llge
圝	lxyx
圞	lxys
土	ffff
圠	fnn
圡	fyi
圢	fsh
圣	cff
圤	fhy
圥	fqb
圦	ftyy
圧	dfd
在	dhfd
圩	fgfh
圪	ftnn
圫	ftan
圬	ffnn
圭	fff
圮	fnn
圯	fnn
地	fbn
圱	tdfg
圲	ftfh
圳	fkh
圴	fqyy
圵	fhg
圶	dff
圷	fghy
圸	fmh
圹	fyt
场	fnrt
圻	frh
圼	jff
圽	fqrt
圾	feyy
圿	fwjh
址	fhg
坁	fqan
坂	frcy
坃	ffqn
坄	fmcy
坅	fwyn
坆	fty
均	fqug
坈	fpmn
坉	fgbn
坊	fyn
坋	fwvn
坌	wvff
坍	fmyg
坎	fqwy
坏	fgiy
坐	wwff
坑	fymn
坒	xxff
坓	fjff
坔	iff
坕	rhyf
坖	fqff
块	fnwy
坘	fgxg
坙	gvff
坚	jcff
坛	ffcy
坜	fdln
坝	fmy
坞	fqng
坟	fyy
坠	bwff
坡	fhcy
坢	fufh
坣	ipff
坤	fjhh
坥	fegg
坦	fjgg
坧	fdg
坨	fpxn
坩	fafg
坪	fguh
坫	fhkg
坬	frcy
坭	fnxn
坮	fckg
坯	fgig
坰	fmkg
坱	fmdy
坲	fxjh
坳	fxln
坴	fwff
坵	frgg
坶	fxgu
坷	fskg
坸	fqkg
坹	fpwy
坺	fdcy
坻	fqay
坼	fryy
坽	fwyc
坾	fpsh
坿	fwfy
垀	ftuh
垁	ftdy
垂	tgaf
垃	fug
垄	dxff
垅	fdxn
垆	fhnt
垇	fmmg
垈	waff
垉	fqnn
垊	fnan
型	gajf
垌	fmgk
垍	fthg
垎	ftkg
垏	fvfh
垐	uqwf
垑	fqqy
垒	cccf
垓	fynw
垔	sff
垕	rgkf
垖	fwnn
垗	fiqn
垘	fwdy
垙	fiqn
垚	ffff
垛	fmsy
垜	fesy
垝	fqdb
垞	fpta
垟	fudh
垠	fvey
垡	waff
垢	frgk
垣	fgjg
垤	fgcf
垥	fwgk
垦	veff
垧	ftmk
垨	fpfy
垩	gogf
垪	fuah
垫	rvyf
垬	fawy
垭	fgog
垮	fdfn
垯	fdpy
垰	fhgh
垱	fivg
垲	fmnn
垳	ftfh
垴	fybh
垵	fpvg
垶	fuh
垷	fhqn
垸	fpfq
垹	fdtb
垺	febg
垻	fmy
垼	tmcf
垽	irff
垾	fjfh
垿	fycb
埀	tguf
埁	fmwn
埂	fgjq
埃	fctd
埄	ftdh
埅	byff
埆	fqeh
埇	fceh
埈	fcwt
埉	fdww
埊	miff
埋	fjfg
埌	fyve
埍	fkeg
城	fdnt
埏	fthp
埐	fvpc
埑	rrff
埒	fefy
埓	fefy
埔	fgey
埕	fkgg
埖	fawx
埗	fhit
埘	fjfy
埙	fkmy
埚	fkmw
埛	fmwk
埜	ssff
埝	fwyn
埞	fpgh
域	fakg
埠	fwnf
埡	fgfg
埢	fudb
埣	fywf
埤	frtf
埥	fgeg
埦	fpqb
埧	fhwy
埨	fwga
埩	fqvh
埪	fpwa
埫	fimk
埬	fgji
埭	fviy
埮	fooy
埯	fdjn
埰	fesy
埱	fhic
埲	fdwh
埳	fqvg
埴	ffhg
埵	ftgf
埶	fwfy
執	fufy
埸	fjqr
培	fukg
基	adwf
埻	fybg
埼	fdsk
埽	fvph
埾	bcff
埿	inxf
堀	fnbm
堁	fjsy
堂	ipkf
堃	yyff
堄	fvqn
堅	ahnf
堆	fwyg
堇	akgf
堈	fmum
堉	fyce
堊	gfgf
堋	feeg
堌	fldg
堍	fqky
堎	ffwt
堏	syff
堐	fdff
堑	lrff
堒	fjxx
堓	fmdf
堔	fpws
堕	bdef
堖	fvtq
堗	fpwd
堘	fudf
堙	fsfg
堚	fplh
堛	fgkl
堜	fgli
堝	fmnk
堞	fans
堟	fxey
堠	fwnd
堡	wksf
堢	fwks
堣	fjmy
堤	fjgh
堥	cbtf
堦	fxxr
堧	fdmd
堨	fjqn
堩	fngg
堪	fadn
堫	fqbt
堬	fwgj
堭	frgg
堮	fkkn
堯	fffq
堰	fajv
報	fufc
堲	vcbf
堳	fnhg
場	fjgr
堵	fftj
堶	fdae
堷	fujg
堸	fmtj
堹	ftgf
堺	flwj
堻	ivff
堼	ffff
堽	flgh
堾	fdwj
堿	fdgt
塀	fnua
塁	liff
塂	fawn
塃	fayq
塄	flyn
塅	fwdc
塆	fyox
塇	fpgg
塈	vcaf
塉	fiwe
塊	frqc
塋	oopf
塌	fjng
塍	eudf
塎	fpwk
塏	fmgu
塐	fgxi
塑	ubtf
塒	fjff
塓	fpju
塔	fawk
塕	fwcn
塖	ftux
塗	iwtf
塘	fyvk
塙	fymk
塚	fpey
塛	fssy
塜	fpge
塝	fupy
塞	pfjf
塟	agqf
塠	fwnp
塡	fxhw
塢	fwno
塣	ikgf
塤	fkmy
塥	fgkh
塦	blff
塧	fuwl
塨	fawn
塩	ftkl
塪	fevg
填	ffhw
塬	fdri
塭	fjlg
塮	ftmf
塯	fqyl
塰	itxf
塱	yvcf
塲	ftjr
塳	ftdp
塴	fmee
塵	ynjf
塶	fynx
塷	fhlo
塸	fakk
塹	lrff
塺	yssf
塻	fajd
塼	fgjf
塽	fdqq
塾	ybvf
塿	flvg
墀	fnih
墁	fjlc
墂	fsfi
境	fujq
墄	fdht
墅	jfcf
墆	faqh
墇	fujh
墈	fadl
墉	fyvh
墊	fuff
墋	fcce
墌	fyao
墍	rxaf
墎	fybb
墏	nhdf
墐	fakg
墑	fumd
墒	fumk
墓	ajdf
墔	fmwy
墕	fgho
墖	fwgl
増	fulj
墘	ffjn
墙	ffuk
墚	fivs
墛	fnff
墜	buef
墝	fffq
增	fulj
墟	fhag
墠	fkkf
墡	fudk
墢	fwxc
墣	fogy
墤	fkhm
墥	fujf
墦	ftol
墧	ftdk
墨	lfof
墩	fybt
墪	ybtf
墫	fusf
墬	bxef
墭	fdnl
墮	bdaf
墯	ndaf
墰	fsjh
墱	fwgu
墲	frlo
墳	ffam
墴	famw
墵	fffc
墶	ffup
墷	fagf
墸	fafj
墹	fujg
墺	ftmd
墻	ffwk
墼	lbmf
墽	fryt
墾	eevf
墿	flff
壀	fnku
壁	nkuf
壂	nawf
壃	fglg
壄	scbf
壅	yxtf
壆	wfqf
壇	fylg
壈	fylt
壉	fhae
壊	ffle
壋	fipl
壌	fufe
壍	ilrf
壎	ftgo
壏	fahl
壐	gwmf
壑	hpgf
壒	fafl
壓	djef
壔	ffnf
壕	fype
壖	ffdj
壗	fvhl
壘	lllf
壙	fyaw
壚	fhal
壛	fuqv
壜	fjfc
壝	fkhp
壞	fyle
壟	uegf
壠	fued
壡	hpgf
壢	fdth
壣	fbxg
壤	fyke
壥	fdlf
壦	faky
壧	fkkt
壨	lllf
壩	ffae
壪	fxyx
士	fghg
壬	tfd
壭	fbj
壮	ufg
壯	nhdf
声	fnr
壱	fpxb
売	fpqb
壳	fpmb
壴	fkuf
壵	ffff
壶	fpog
壷	fpkg
壸	fpgg
壹	fpgu
壺	fpfg
壻	fnhe
壼	fpgg
壽	fnaf
壾	fkun
壿	fusf
夀	fnkf
夁	flld
夂	ttny
夃	eci
处	thi
夅	tahj
夆	tdhj
备	tlf
夈	tou
変	yotu
夊	qyi
夋	cwtu
夌	fwtu
复	tjtu
夎	wwft
夏	dhtu
夐	qmwt
夑	oyot
夒	ghtt
夓	wfdt
夔	uhtt
夕	qtny
外	qhy
夗	qbn
夘	qbh
夙	mgqi
多	qqu
夛	vqu
夜	ywty
夝	qtgg
夞	qhkx
够	qkqq
夠	qqqk
夡	qqfk
夢	alpq
夣	yclq
夤	qpgw
夥	jsqq
夦	adwq
大	dddd
夨	gnyi
天	gdi
太	dyi
夫	fwi
夬	nwi
夭	tdi
央	mdi
夯	dlb
夰	djj
失	rwi
夲	dfj
夳	dff
头	udi
夵	diu
夶	ddy
夷	gxwi
夸	dfnb
夹	guwi
夺	dfu
夻	dkf
夼	dkj
夽	dfcu
夾	dwwi
夿	dcb
奀	gidu
奁	daqu
奂	qmdu
奃	dqay
奄	djnb
奅	dqtb
奆	danf
奇	dskf
奈	dfiu
奉	dwfh
奊	ffgy
奋	dlf
奌	hkdu
奍	udjj
奎	dfff
奏	dwgd
奐	qmwd
契	dhvd
奒	dynw
奓	dqqu
奔	dfaj
奕	yodu
奖	uqdu
套	ddu
奘	nhdd
奙	cdjn
奚	exdu
奛	djef
奜	djdd
奝	dmfk
奞	dwyf
奟	deef
奠	usgd
奡	dhdj
奢	dftj
奣	gdje
奤	ddmd
奥	tmod
奦	cbtd
奧	tmtd
奨	uefd
奩	dakk
奪	dwyf
奫	dijg
奬	nhdd
奭	ddjj
奮	dwyl
奯	dhdt
奰	llld
奱	xyxd
奲	dftf
女	vvvv
奴	vcy
奵	vsh
奶	ven
奷	vtfh
奸	vfh
她	vbn
奺	vqyy
奻	vvg
奼	vtan
好	vbg
奾	vmh
奿	vyvd
妀	nvg
妁	vqyy
如	vkg
妃	vnn
妄	ynvf
妅	vag
妆	uvg
妇	vvg
妈	vcg
妉	vpqn
妊	vtfg
妋	vfwy
妌	vfjh
妍	vgah
妎	vwjh
妏	vyy
妐	vwcy
妑	vcn
妒	vynt
妓	vfcy
妔	vymn
妕	vkhh
妖	vtdy
妗	vwyn
妘	vfcy
妙	vitt
妚	vgiy
妛	bhgv
妜	vnwy
妝	nhdv
妞	vnfg
妟	jvf
妠	vmwy
妡	vrh
妢	vwvn
妣	vxxn
妤	vcbh
妥	evf
妦	vdhh
妧	vfqn
妨	vyn
妩	vfqn
妪	vaqy
妫	vyly
妬	vdg
妭	vdcy
妮	vnxn
妯	vmg
妰	vthf
妱	vvkg
妲	vjgg
妳	vqiy
妴	qbvf
妵	vygg
妶	vyxy
妷	vrwy
妸	vskg
妹	vfiy
妺	vgsy
妻	gvhv
妼	vntt
妽	vjhh
妾	uvf
妿	lkvf
姀	vty
姁	vqkg
姂	vtpy
姃	vghg
姄	vnan
姅	vufh
姆	vxgu
姇	wfvf
姈	vwyc
姉	vgmh
姊	vtnt
始	vckg
姌	vmfg
姍	vmah
姎	vmdy
姏	vafg
姐	vegg
姑	vdg
姒	vnyw
姓	vtgg
委	tvf
姕	hxvf
姖	vang
姗	vmmg
姘	vuah
姙	vwtf
姚	viqn
姛	vmgk
姜	ugvf
姝	vriy
姞	vfkg
姟	vynw
姠	vtmk
姡	vtdg
姢	vceg
姣	vuqy
姤	vrgk
姥	vftx
姦	vvvf
姧	vvfh
姨	vgxw
姩	vrhf
姪	vgcf
姫	vahh
姬	vahh
姭	lllv
姮	vgjg
姯	viqn
姰	vqjg
姱	vdfn
姲	vpvg
姳	vqkg
姴	gqjv
姵	vmgh
姶	vwgk
姷	vdeg
姸	vftf
姹	vpta
姺	vtfq
姻	vldy
姼	vqqy
姽	vqdb
姾	vwgg
姿	uqwv
娀	vadt
威	dgvt
娂	vawy
娃	vffg
娄	ovf
娅	vgog
娆	vatq
娇	vtdj
娈	yovf
娉	vmgn
娊	vhqn
娋	vieg
娌	vjfg
娍	vdnt
娎	rrvf
娏	vdne
娐	vebg
娑	iitv
娒	vtxu
娓	vntn
娔	vdqn
娕	vgki
娖	vkhy
娗	vtfp
娘	vyve
娙	vgva
娚	vlln
娛	vknd
娜	vvfb
娝	vgik
娞	vevg
娟	vkeg
娠	vdfe
娡	vfny
娢	vwyk
娣	vuxt
娤	nhdv
娥	vtrt
娦	vrgw
娧	vukq
娨	vjfh
娩	vqkq
娪	vgkg
娫	vthp
娬	vgah
娭	vctd
娮	llb
娯	vknw
娰	vwnw
娱	vkgd
娲	vkmw
娳	vtjh
娴	vusy
娵	vbcy
娶	bcvf
娷	vtgf
娸	vadw
娹	vxyx
娺	vccc
娻	vgji
娼	vjjg
娽	vviy
娾	vdff
娿	bskv
婀	vbsk
婁	lvf
婂	vrmh
婃	vpfi
婄	vukg
婅	vqoy
婆	ihcv
婇	vesy
婈	vfwt
婉	vpqb
婊	vgey
婋	vham
婌	vhic
婍	vdsk
婎	vwyg
婏	vqky
婐	vjsy
婑	vtvg
婒	vooy
婓	djdv
婔	vdjd
婕	vgvh
婖	vgdn
婗	vvqn
婘	vudb
婙	vqvh
婚	vqaj
婛	vyiy
婜	ahnv
婝	vpgh
婞	vfuf
婟	vldg
婠	vpnn
婡	vsww
婢	vrtf
婣	vjgg
婤	vmfk
婥	vhjh
婦	vvph
婧	vgeg
婨	vwga
婩	vmdf
婪	ssvf
婫	vjxx
婬	vetf
婭	vgfg
婮	vndg
婯	gmyv
婰	vmaw
婱	xyxv
婲	vawx
婳	vglb
婴	mmvf
婵	vujf
婶	vpjh
婷	vyps
婸	vjgr
婹	vsvg
婺	cbtv
婻	vfmf
婼	vadk
婽	vnhc
婾	vwgb
婿	vnhe
媀	vjmy
媁	vnhh
媂	vuph
媃	vcbs
媄	vugd
媅	vadn
媆	vdmd
媇	vusy
媈	vplh
媉	vngf
媊	vuej
媋	vdwj
媌	valg
媍	vqmy
媎	vftj
媏	vmdj
媐	ahkv
媑	vtgf
媒	vafs
媓	vrgg
媔	vdmd
媕	vwga
媖	vamd
媗	vpgg
媘	vxxr
媙	vdgt
媚	vnhg
媛	vefc
媜	vhmy
媝	tovf
媞	vjgh
媟	vans
媠	vdae
媡	vgli
媢	vjhg
媣	vivs
媤	vlny
媥	vyna
媦	vleg
媧	vmnk
媨	vusg
媩	vdeg
媪	vjlg
媫	vhvh
媬	vwks
媭	edmv
媮	vwgj
媯	vyto
媰	vqbt
媱	verm
媲	vtlx
媳	vthn
媴	vfke
媵	eudv
媶	vabg
媷	vdff
媸	vbhj
媹	vqyl
媺	vmgt
媻	temv
媼	vlwl
媽	vcy
媾	vfjf
媿	vrqc
嫀	vdwt
嫁	vpey
嫂	vvhc
嫃	vfhw
嫄	vdri
嫅	vuda
嫆	vpwk
嫇	vpju
嫈	oopv
嫉	vutd
嫊	vgxi
嫋	vxuu
嫌	vuvo
嫍	vevg
嫎	vupy
嫏	vyvb
嫐	vllv
嫑	gisv
嫒	vepc
嫓	vqmx
嫔	vprw
嫕	vatn
嫖	vsfi
嫗	vakk
嫘	vlxi
嫙	vyth
嫚	vjlc
嫛	atdv
嫜	vujh
嫝	vyvi
嫞	vyvh
嫟	vaak
嫠	fitv
嫡	vumd
嫢	fwhv
嫣	vgho
嫤	vakg
嫥	vgjf
嫦	viph
嫧	vgmy
嫨	vakw
嫩	vgkt
嫪	vnwe
嫫	vajd
嫬	vyao
嫭	vhah
嫮	vffn
嫯	gqtv
嫰	vgkw
嫱	vfuk
嫲	vyss
嫳	umiv
嫴	vduh
嫵	vrlo
嫶	vwyo
嫷	vbde
嫸	vudk
嫹	vamw
嫺	vueg
嫻	vusy
嫼	vlfo
嫽	vdui
嫾	voqh
嫿	vvfg
嬀	veto
嬁	vwgu
嬂	vuaj
嬃	edmv
嬄	vfpu
嬅	vagf
嬆	vwgn
嬇	vkhm
嬈	vffq
嬉	vfkk
嬊	aukv
嬋	vkkf
嬌	vtdk
嬍	vmgt
嬎	vqkg
嬏	vtol
嬐	vwgw
嬑	vujn
嬒	vwgj
嬓	vryt
嬔	vqkg
嬕	vlff
嬖	nkuv
嬗	vylg
嬘	vuep
嬙	vfwk
嬚	vyuo
嬛	vlge
嬜	ujqv
嬝	vwve
嬞	vatf
嬟	vugt
嬠	vkks
嬡	vept
嬢	vufe
嬣	vpns
嬤	vysx
嬥	vnwy
嬦	vfnf
嬧	vvhl
嬨	vuxn
嬩	vwfw
嬪	vpgm
嬫	voos
嬬	vfdj
嬭	vgwq
嬮	djev
嬯	vfkf
嬰	mmvf
嬱	ilrv
嬲	llvl
嬳	vawc
嬴	ynky
嬵	vxrh
嬶	vthj
嬷	vysc
嬸	vptl
嬹	vwfw
嬺	vaan
嬻	vflm
嬼	vqyj
嬽	vlhd
嬾	vgkm
嬿	vauo
孀	vfsh
孁	fkkv
孂	vtvl
孃	vyke
孄	vugi
孅	vwwg
孆	vmmv
孇	vwyc
孈	vmwk
孉	vaky
孊	vysd
孋	vgmx
孌	xyxv
孍	vkkt
孎	vnij
孏	vaui
子	bbbb
孑	bnhg
孒	bgd
孓	byi
孔	bnn
孕	ebf
孖	bbg
字	pbf
存	dhbd
孙	biy
孚	ebf
孛	fpbf
孜	bty
孝	ftbf
孞	bnu
孟	blf
孠	ngkb
孡	bckg
孢	bqnn
季	tbf
孤	brcy
孥	vcbf
学	ipbf
孧	xlbf
孨	bbbf
孩	bynw
孪	yobf
孫	btxi
孬	givb
孭	bmy
孮	bpfi
孯	ahnb
孰	ybvy
孱	nbbb
孲	bgfg
孳	gcff
孴	bbbj
孵	qytb
孶	yxyb
孷	fitb
學	wfqb
孹	nkub
孺	bfdj
孻	bvhl
孼	btwb
孽	awnb
孾	bmmv
孿	xyxb
宀	pyyn
宁	psj
宂	pmb
它	pxb
宄	pvb
宅	ptab
宆	pxb
宇	pgfj
守	pfu
安	pvf
宊	pdu
宋	psu
完	pfqb
宍	puu
宎	ptdu
宏	pdcu
宐	phng
宑	pfjj
宒	ptfn
宓	pntr
宔	pygf
宕	pdf
宖	pxcu
宗	pfiu
官	pnhn
宙	pmf
定	pghu
宛	pqbb
宜	pegf
宝	pgyu
实	pudu
実	pdwu
宠	pdxb
审	pjhj
客	ptkf
宣	pgjg
室	pgcf
宥	pdef
宦	pahh
宧	pahh
宨	piqb
宩	pou
宪	ptfq
宫	pkkf
宬	pdnt
宭	pvtk
宮	pktk
宯	pftb
宰	puj
宱	pwtf
宲	pksu
害	pdhk
宴	pjvf
宵	pief
家	peu
宷	ptou
宸	pdfe
容	pwwk
宺	pkgq
宻	pcum
宼	pfqv
宽	pamq
宾	prgw
宿	pwdj
寀	pesu
寁	pgvh
寂	phic
寃	pqky
寄	pdsk
寅	pgmw
密	pntm
寇	pfqc
寈	pgef
寉	pwyf
寊	phmu
寋	pfjb
富	pgkl
寍	pnlf
寎	pnhw
寏	pqmd
寐	pnhi
寑	pwvc
寒	pfju
寓	pjmy
寔	pjgh
寕	pdls
寖	pivc
寗	pntf
寘	pfhw
寙	prcy
寚	pgrm
寛	pahq
寜	pnlh
寝	puvc
寞	pajd
察	pwfi
寠	plvf
寡	pdev
寢	pnhc
寣	pnhy
寤	pnhk
寥	pnwe
實	pxfm
寧	pgng
寨	pfjs
審	ptol
寪	peto
寫	pvqo
寬	pahy
寭	pgjn
寮	pdui
寯	pwym
寰	plge
寱	pnhs
寲	pxth
寳	pgqm
寴	pusq
寵	pued
寶	pgrm
寷	pdhu
寸	fghy
对	cfy
寺	ffu
寻	vfu
导	nfu
寽	efu
対	yfy
寿	dtfu
尀	akfy
封	fffy
専	gmfu
尃	gehf
射	tmdf
尅	dqfi
将	uqfy
將	nhdf
專	gjhf
尉	nfif
尊	usgf
尋	vakf
尌	fkuf
對	oguf
導	uthf
小	ihty
尐	iyu
少	itr
尒	wiu
尓	tiu
尔	qiu
尕	eiu
尖	idu
尗	hiu
尘	iff
尙	imkf
尚	imkf
尛	iiiu
尜	idiu
尝	ipfc
尞	duji
尟	jght
尠	adwt
尡	iqjx
尢	dnv
尣	wqb
尤	dnv
尥	dnqy
尦	wqqy
尧	atgq
尨	dnee
尩	wqgd
尪	dngd
尫	gqgd
尬	dnwj
尭	faqb
尮	dnes
尯	dnqb
尰	dntf
就	yidn
尲	dnuo
尳	dnme
尴	dnjl
尵	dnkm
尶	gqal
尷	dnal
尸	nngt
尹	vte
尺	nyi
尻	nvv
尼	nxv
尽	nyuu
尾	ntfn
尿	nii
局	nnkd
屁	nxxv
层	nfci
屃	nmi
屄	npwi
居	ndd
屆	nfbk
屇	nld
屈	nbmk
屉	nanv
届	nmd
屋	ngcf
屌	nkmh
屍	ngqx
屎	noi
屏	nuak
屐	ntfc
屑	nied
屒	ndfe
屓	nmi
屔	rgnx
展	naei
屖	nuk
屗	ntff
屘	ntfb
屙	nbsk
屚	nfi
屛	ntff
屜	ntan
屝	ndjd
属	ntky
屟	nans
屠	nftj
屡	novd
屢	nlvd
屣	nthh
層	nulj
履	nttt
屦	ntov
屧	ntas
屨	ntlv
屩	nttk
屪	npdi
屫	nnhk
屬	nilj
屭	nmmm
屮	bhk
屯	gbnv
屰	ubtr
山	mmmm
屲	tmj
屳	tymj
屴	mlb
屵	mdr
屶	mvb
屷	men
屸	mag
屹	mtnn
屺	mnn
屻	mvyy
屼	mgqn
屽	mfh
屾	mmh
屿	mgng
岀	mmj
岁	mqu
岂	mnb
岃	mvyu
岄	meg
岅	mrcy
岆	mtdy
岇	mqbj
岈	maht
岉	mqrt
岊	cmj
岋	meyy
岌	meyu
岍	mgah
岎	mwvn
岏	mfqn
岐	mfcy
岑	mwyn
岒	mwyn
岓	mrh
岔	wvmj
岕	mwjj
岖	maqy
岗	mmqu
岘	mmqn
岙	tdmj
岚	mmqu
岛	qynm
岜	mcb
岝	mthf
岞	mthf
岟	mmdy
岠	mang
岡	mumk
岢	mskf
岣	mqkg
岤	mpwy
岥	mhcy
岦	muf
岧	mvkf
岨	megg
岩	mdf
岪	mxjj
岫	mmg
岬	mlh
岭	mwyc
岮	mpxn
岯	mgig
岰	mxln
岱	wamj
岲	mkqn
岳	rgmj
岴	mrgg
岵	mdg
岶	mrg
岷	mnan
岸	mdfj
岹	mvkg
岺	mwyc
岻	mqay
岼	mguh
岽	maiu
岾	mhkg
岿	mjvf
峀	mmf
峁	mqtb
峂	mtuy
峃	ipmj
峄	mcfh
峅	mcah
峆	mwgk
峇	mwgk
峈	mtkg
峉	mtkf
峊	wnnm
峋	mqjg
峌	mgcf
峍	mvfh
峎	mveu
峏	mdmj
峐	mynw
峑	mwgf
峒	mmgk
峓	mgxw
峔	mftx
峕	myjf
峖	mpvg
峗	mqdb
峘	mgjg
峙	mffy
峚	mdff
峛	mgqj
峜	mwhf
峝	mmgk
峞	mqdb
峟	mdef
峠	mhgh
峡	mguw
峢	mgqj
峣	matq
峤	mtdj
峥	mqvh
峦	yomj
峧	muqy
峨	mtrt
峩	mtrt
峪	mwwk
峫	mahb
峬	mgey
峭	mieg
峮	mvtk
峯	mtdh
峰	mtdh
峱	qtnm
峲	mtjj
峳	mwht
峴	mhqn
峵	mpdc
島	wvgm
峷	muj
峸	mdnt
峹	wtmj
峺	mgjq
峻	mcwt
峼	mtfk
峽	mdww
峾	irmj
峿	mgkg
崀	myve
崁	mfqw
崂	mapl
崃	mgoy
崄	mwgi
崅	mqeh
崆	mpwa
崇	mpfi
崈	pfim
崉	mijg
崊	mssy
崋	mgaf
崌	mndg
崍	msww
崎	mdsk
崏	mqaj
崐	mjxx
崑	mjxx
崒	mywf
崓	mldg
崔	mwyf
崕	mdff
崖	mdff
崗	mmum
崘	mwga
崙	mwga
崚	mfwt
崛	mnbm
崜	mtgf
崝	mgeg
崞	mybg
崟	mqf
崠	mgji
崡	mbib
崢	mevh
崣	mtvf
崤	mqde
崥	mrtf
崦	mdjn
崧	mswc
崨	mgvh
崩	meef
崪	mywf
崫	mnbm
崬	mgji
崭	mlrj
崮	mldf
崯	mqg
崰	mvlg
崱	mmjj
崲	mrgg
崳	mwgj
崴	mdgt
崵	mjgr
崶	mfff
崷	musg
崸	mdmy
崹	muph
崺	mytb
崻	mtff
崼	mjgh
崽	mlnu
崾	msvg
崿	mkkn
嵀	msyg
嵁	madn
嵂	mtvh
嵃	mute
嵄	mugd
嵅	mdgt
嵆	tdnm
嵇	tdnm
嵈	mefc
嵉	myps
嵊	mtux
嵋	mnhg
嵌	mafw
嵍	cbtm
嵎	mjmy
嵏	mqbt
嵐	mmtj
嵑	mjqn
嵒	kkkm
嵓	mkkk
嵔	mlge
嵕	mqbt
嵖	msjg
嵗	mdgt
嵘	maps
嵙	mtuf
嵚	mqqw
嵛	mwgj
嵜	mukh
嵝	movg
嵞	wtmm
嵟	mdwy
嵠	mexd
嵡	mwcn
嵢	mwyk
嵣	myvk
嵤	oopm
嵥	mqas
嵦	mmgu
嵧	mqyl
嵨	mwno
嵩	mymk
嵪	mymk
嵫	muxx
嵬	mrqc
嵭	mupy
嵮	mfhw
嵯	muda
嵰	muvo
嵱	mpwk
嵲	mths
嵳	muda
嵴	miwe
嵵	mjff
嵶	mxuu
嵷	mtwh
嵸	mtwh
嵹	mxkj
嵺	mnwe
嵻	myvi
嵼	mutg
嵽	maqh
嵾	mcce
嵿	msdm
嶀	mffn
嶁	mlvg
嶂	mujh
嶃	mlrh
嶄	mlrj
嶅	gqtm
嶆	mgmj
嶇	makk
嶈	mnhf
嶉	mkwy
嶊	mrwy
嶋	mwvo
嶌	mwvo
嶍	mnrg
嶎	mnff
嶏	mdsn
嶐	mbtg
嶑	mqje
嶒	mulj
嶓	mtol
嶔	mqqw
嶕	mwyo
嶖	mwgn
嶗	mool
嶘	msaa
嶙	moqh
嶚	mdui
嶛	mdui
嶜	maqj
嶝	mwgu
嶞	bdam
嶟	musf
嶠	mtdk
嶡	mduw
嶢	mffq
嶣	mwyo
嶤	mffq
嶥	mduw
嶦	mqdy
嶧	mlff
嶨	wfqm
嶩	mmae
嶪	mogw
嶫	mogw
嶬	mugt
嶭	mwnu
嶮	mwgw
嶯	mkbt
嶰	mqeh
嶱	majn
嶲	mwym
嶳	meff
嶴	tmom
嶵	mldd
嶶	mtmt
嶷	mxth
嶸	moos
嶹	mfnf
嶺	mwym
嶻	mfay
嶼	mwfw
嶽	mqtd
嶾	mean
嶿	mfdj
巀	miwa
巁	mday
巂	mwyk
巃	mued
巄	mued
巅	mfhm
巆	mook
巇	mhaa
巈	mafo
巉	mqky
巊	mmmv
巋	mwnh
巌	midt
巍	mtvc
巎	mght
巏	maky
巐	myma
巑	mtfm
巒	xyxm
巓	mxhm
巔	mfhm
巕	muwv
巖	mkkt
巗	mkkt
巘	mhad
巙	muht
巚	mhad
巛	vnnn
巜	bnn
川	kthh
州	ytyh
巟	ynqb
巠	gvaf
巡	vpv
巢	vjsu
巣	ijsu
巤	vlqn
工	aaaa
左	daf
巧	agnn
巨	and
巩	amyy
巪	annb
巫	awwi
巬	amfw
巭	alfw
差	udaf
巯	cayq
巰	gvaq
己	nngn
已	nnnn
巳	nngn
巴	cnhn
巵	rgcv
巶	vknn
巷	awnb
巸	ahkn
巹	bign
巺	nngw
巻	udnb
巼	ckxb
巽	nnaw
巾	mhk
巿	gmhk
帀	gmhk
币	tmhk
市	ymhj
布	dmhj
帄	mhsh
帅	jmhh
帆	mhmy
帇	vmhk
师	jgmh
帉	mhwv
帊	mhcn
帋	qamh
希	qdmh
帍	ynmh
帎	mhpq
帏	mhfh
帐	mhty
帑	vcmh
帒	wamh
帓	mhgs
帔	mhhc
帕	mhrg
帖	mhhk
帗	mhdc
帘	pwmh
帙	mhrw
帚	vpmh
帛	rmhj
帜	mhkw
帝	upmh
帞	mhdj
帟	yomh
帠	vmhj
帡	mhua
帢	mhwk
帣	udmh
帤	vkmh
帥	wnnh
带	gkph
帧	mhhm
帨	mhuq
帩	mhie
帪	mhde
師	wnnh
帬	vtkh
席	yamh
帮	dtbh
帯	gkgh
帰	ytvh
帱	mhdf
帲	mhtf
帳	mhde
帴	mhaa
帵	mhpb
帶	aqph
帷	mhwy
常	ipkh
帹	mhuv
帺	mhaw
帻	mhgm
帼	mhly
帽	mhjh
帾	mhfj
帿	mhwd
幀	mhhm
幁	mhdm
幂	pjdh
幃	mhnh
幄	mhnf
幅	mhgl
幆	mhjn
幇	fffh
幈	mhna
幉	mhas
幊	mham
幋	temh
幌	mhjq
幍	mhev
幎	mhpu
幏	mhpe
幐	eudh
幑	tmtt
幒	mhtn
幓	mhce
幔	mhjc
幕	ajdh
幖	mhsi
幗	mhlg
幘	mhgm
幙	mhad
幚	dtbh
幛	mhuj
幜	mhji
幝	mhkf
幞	mhoy
幟	mhuj
幠	mhro
幡	mhtl
幢	mhuf
幣	umih
幤	imkh
幥	mhir
幦	nkuh
幧	mhks
幨	mhqy
幩	mhfm
幪	mhae
幫	fffh
幬	mhff
幭	mhat
幮	mhyf
幯	mhtb
幰	mhpn
幱	mhui
干	fggh
平	guhk
年	rhfk
幵	ftfh
并	uaj
幷	tftf
幸	fufj
幹	fjwf
幺	xnny
幻	xnn
幼	xln
幽	xxmk
幾	xxdt
广	yygt
庀	yxv
庁	ysk
庂	ywi
広	yci
庄	yfd
庅	ytci
庆	ydi
庇	yxxv
庈	ywyn
庉	ygbn
床	ysi
庋	yfci
庌	yaht
庍	yrk
庎	ywjk
序	ycbk
庐	yyne
庑	yfqv
庒	yfyi
库	ylk
应	yid
底	yqay
庖	yqnv
店	yhkd
庘	ylk
庙	ymd
庚	yvwi
庛	yhxv
府	ywfi
庝	ytui
庞	ydxv
废	ynty
庠	yudk
庡	yyei
庢	ygcf
庣	yiqv
庤	yffi
庥	ywsi
度	yaci
座	ywwf
庨	yftb
庩	ywti
庪	yrfc
庫	ylk
庬	ydne
庭	ytfp
庮	ysgd
庯	ygey
庰	yuak
庱	yfwt
庲	ysww
庳	yrtf
庴	yajd
庵	ydjn
庶	yaoi
康	yvii
庸	yveh
庹	yany
庺	ywcs
庻	yaww
庼	yxdm
庽	yjmy
庾	yvwi
庿	yald
廀	ypoc
廁	ymjk
廂	yshd
廃	ywfq
廄	yvcc
廅	yfcl
廆	yrqc
廇	yqyl
廈	ydht
廉	yuvo
廊	yyvb
廋	yvhc
廌	ynjo
廍	yukb
廎	yxdm
廏	yrxc
廐	yrxq
廑	yakg
廒	ygqt
廓	yybb
廔	ylvd
廕	ybwc
廖	ynwe
廗	yaqh
廘	yynx
廙	ylaw
廚	yfkf
廛	yjff
廜	ynfj
廝	yadr
廞	yqqw
廟	yfje
廠	yimt
廡	yrlo
廢	ywxc
廣	yamw
廤	ylkx
廥	ywgj
廦	ynku
廧	yfwk
廨	yqeh
廩	yylt
廪	yyli
廫	yene
廬	yhal
廭	ytgm
廮	ymmv
廯	yqod
廰	ybfn
廱	yvky
廲	ygmx
廳	ybgn
廴	pny
廵	vpv
延	thpd
廷	tfpd
廸	mpd
廹	rpd
建	vfhp
廻	lkpd
廼	spd
廽	mjdp
廾	agth
廿	aghg
开	gak
弁	caj
异	naj
弃	ycaj
弄	gaj
弅	wvaj
弆	fcaj
弇	wgka
弈	yoaj
弉	nhda
弊	umia
弋	agny
弌	agd
弍	afd
弎	add
式	aad
弐	gafd
弑	qsaa
弒	qsya
弓	xngn
弔	xhk
引	xhh
弖	xgf
弗	xjk
弘	xcy
弙	xgfh
弚	uxhj
弛	xbn
弜	xxn
弝	xcn
弞	xqwy
弟	uxht
张	xtay
弡	xang
弢	xbhc
弣	xwfy
弤	xqay
弥	xqiy
弦	xyxy
弧	xrcy
弨	xvkg
弩	vcxb
弪	xcag
弫	xahh
弬	xahh
弭	xbg
弮	udxb
弯	yoxb
弰	xieg
弱	xuxu
弲	xkeg
弳	xgva
弴	xybg
張	xdey
弶	xyiy
強	xcjy
弸	xeeg
弹	xujf
强	xkjy
弻	xgkx
弼	xdjx
弽	xans
弾	xijf
弿	pfjx
彀	fpgc
彁	xskk
彂	ogxd
彃	xjaf
彄	xakk
彅	xuev
彆	umix
彇	xvfj
彈	xkkf
彉	xamw
彊	xglg
彋	xlge
彌	xgwq
彍	xyaw
彎	xyxx
彏	xhhc
彐	vngg
彑	xgd
归	jvg
当	ivf
彔	xgiu
录	viu
彖	xeu
彗	dhdv
彘	xgxx
彙	xgps
彚	vpjs
彛	vowa
彜	xgoa
彝	xgoa
彞	voxa
彟	vfac
彠	vakc
彡	ettt
形	gaet
彣	yee
彤	myet
彥	yder
彦	uter
彧	akge
彨	gmye
彩	eset
彪	hame
彫	mfke
彬	sset
彭	fkue
彮	pwwe
彯	sfie
彰	ujet
影	jyie
彲	gmye
彳	ttth
彴	tqyy
彵	tbn
彶	teyy
彷	tyn
彸	twcy
役	tmcy
彺	tgg
彻	tavn
彼	thcy
彽	tqay
彾	twyc
彿	txjh
往	tygg
征	tghg
徂	tegg
徃	ttgg
径	tcag
待	tffy
徆	tsg
徇	tqjg
很	tvey
徉	tudh
徊	tlkg
律	tvfh
後	txty
徍	tffg
徎	tkgg
徏	thit
徐	twty
徑	tgva
徒	tfhy
従	tuhy
徔	tapy
徕	tgoy
徖	tpfi
得	tjgf
徘	tdjd
徙	thhy
徚	tgli
徛	tdsk
徜	timk
徝	tfhg
從	twwh
徟	tmfk
徠	tsww
御	trhb
徢	tgvh
徣	tajg
徤	tvfp
徥	tjgh
徦	tnhc
徧	tyna
徨	trgg
復	ttjt
循	trfh
徫	tnhh
徬	tupy
徭	term
微	tmgt
徯	texd
徰	tghh
徱	tsfi
徲	tnih
徳	tfln
徴	tmgt
徵	tmgt
徶	tumt
德	tfln
徸	tujf
徹	tyct
徺	tffq
徻	twgj
徼	tryt
徽	tmgt
徾	tmyt
徿	tued
忀	tyke
忁	tjbi
忂	thhy
心	nyny
忄	nyhy
必	nte
忆	nnn
忇	nln
忈	fnu
忉	nvn
忊	nsh
忋	nnn
忌	nnu
忍	vynu
忎	tfnu
忏	ntfh
忐	hnu
忑	ghnu
忒	ani
忓	nfh
忔	ntnn
忕	ndy
忖	nfy
志	fnu
忘	ynnu
忙	nynn
忚	nbn
忛	nmyy
応	yni
忝	gdnu
忞	ynu
忟	nyy
忠	khnu
忡	nkhh
忢	gnu
忣	neyy
忤	ntfh
忥	rnnu
忦	nwjh
忧	ndnn
忨	nfqn
忩	wcnu
忪	nwcy
快	nnwy
忬	ncbh
忭	nyhy
忮	nfcy
忯	nqan
忰	nvfh
忱	npqn
忲	ndyy
忳	ngbn
忴	nwyn
念	wynn
忶	nfcy
忷	nqbh
忸	nnfg
忹	ngg
忺	nqwy
忻	nrh
忼	nymn
忽	qrnu
忾	nrnn
忿	wvnu
怀	ngiy
态	dynu
怂	wwnu
怃	nfqn
怄	naqy
怅	ntay
怆	nwbn
怇	nang
怈	nann
怉	nqnn
怊	nvkg
怋	nnan
怌	ngig
怍	nthf
怎	thfn
怏	nmdy
怐	nqkg
怑	nufh
怒	vcnu
怓	nvcy
怔	nghg
怕	nrg
怖	ndmh
怗	nhkg
怘	dnu
怙	ndg
怚	negg
怛	njgg
怜	nwyc
思	lnu
怞	nmg
怟	nqay
怠	cknu
怡	nckg
怢	nrwy
怣	rwnu
怤	wfnu
急	qvnu
怦	nguh
性	ntgg
怨	qbnu
怩	nnxn
怪	ncfg
怫	nxjh
怬	nlg
怭	nntt
怮	nxln
怯	nfcy
怰	nyxy
怱	qryn
怲	ngmw
怳	nkqn
怴	nant
怵	nsyy
怶	nhcy
怷	fqyn
怸	synu
怹	wbnu
怺	nyni
总	uknu
怼	cfnu
怽	nfiy
怾	nkwy
怿	ncfh
恀	nqqy
恁	wtfn
恂	nqjg
恃	nffy
恄	nfkg
恅	nftx
恆	nghg
恇	nagg
恈	ncrh
恉	nxjg
恊	nlll
恋	yonu
恌	niqn
恍	niqn
恎	ngcf
恏	vbnu
恐	amyn
恑	nqdb
恒	ngjg
恓	nsg
恔	nuqy
恕	vknu
恖	tlqn
恗	ndfn
恘	nwsy
恙	ugnu
恚	ffnu
恛	nlkg
恜	naag
恝	dhvn
恞	ngxw
恟	nqqb
恠	ndhf
恡	nqdc
恢	ndoy
恣	uqwn
恤	ntlg
恥	bny
恦	ntmk
恧	dmjn
恨	nvey
恩	ldnu
恪	ntkg
恫	nmgk
恬	ntdg
恭	awnu
恮	nwgg
息	thnu
恰	nwgk
恱	nwcq
恲	nuah
恳	venu
恴	yjnu
恵	gmnu
恶	gogn
恷	wsnu
恸	nfcl
恹	nddy
恺	nmnn
恻	nmjh
恼	nybh
恽	nplh
恾	nayn
恿	cenu
悀	nceh
悁	nkeg
悂	nxxf
悃	nlsy
悄	nieg
悅	nwkq
悆	wtnu
悇	nwty
悈	naah
悉	tonu
悊	rrnu
悋	ktuf
悌	nuxt
悍	njfh
悎	ntfk
悏	ndww
悐	qton
悑	ngey
悒	nkcn
悓	nhqn
悔	ntxu
悕	nqdh
悖	nfpb
悗	nqkq
悘	atdn
悙	nybh
悚	ngki
悛	ncwt
悜	nkgg
悝	njfg
悞	nknd
悟	ngkg
悠	whtn
悡	tjnu
悢	nyve
患	kkhn
悤	tltn
悥	ynu
悦	nukq
悧	ntjh
您	wqin
悩	niqb
悪	gkjn
悫	fpmn
悬	egcn
悭	njcf
悮	nkgd
悯	nuyy
悰	npfi
悱	ndjd
悲	djdn
悳	fhnn
悴	nywf
悵	ndey
悶	uni
悷	nynd
悸	ntbg
悹	pnhn
悺	npnn
悻	nfuf
悼	nhjh
悽	ngvv
悾	npwa
悿	ngdn
惀	nwga
惁	srnu
惂	nqvg
惃	njxx
惄	hicn
情	ngeg
惆	nmfk
惇	nybg
惈	njsy
惉	ihkn
惊	nyiy
惋	npqb
惌	pqbn
惍	nqg
惎	adwn
惏	nssy
惐	nakg
惑	akgn
惒	tknu
惓	nudb
惔	nooy
惕	njqr
惖	jqrn
惗	nwyn
惘	nmun
惙	nccc
惚	nqrn
惛	nqaj
惜	najg
惝	nimk
惞	nrqw
惟	nwyg
惠	gjhn
惡	gfgn
惢	nnnu
惣	trqn
惤	nxyx
惥	vwnu
惦	nyhk
惧	nhwy
惨	ncde
惩	tghn
惪	fhnu
惫	tlnu
惬	nagw
惭	nlrh
惮	nujf
惯	nxfm
惰	ndae
惱	nvtq
惲	nplh
想	shnu
惴	nmdj
惵	nans
惶	nrgg
惷	dwjn
惸	nqjb
惹	adkn
惺	njtg
惻	nmjh
惼	nyna
惽	nnaj
惾	nqbt
惿	njgh
愀	ntoy
愁	tonu
愂	fpbn
愃	npgg
愄	nlge
愅	nafh
愆	tifn
愇	nnhh
愈	wgen
愉	nwgj
愊	ngkl
愋	nefc
愌	nqmd
愍	natn
愎	ntjt
意	ujnu
愐	ndmd
愑	ncel
愒	njqn
愓	njgr
愔	nujg
愕	nkkn
愖	nadn
愗	cbtn
愘	nptk
愙	ptkn
愚	jmhn
愛	epnt
愜	nadw
愝	najv
愞	ndmd
感	dgkn
愠	njlg
愡	nqrn
愢	nlny
愣	nlyn
愤	nfam
愥	namd
愦	nkhm
愧	nrqc
愨	fpgn
愩	namy
愪	nkmy
愫	ngxi
愬	ubtn
愭	nftj
愮	nerm
愯	nwyc
愰	njiq
愱	nutd
愲	nmeg
愳	hhnu
愴	nwyk
愵	nxuu
愶	nlle
愷	nmgu
愸	swwn
愹	npwk
愺	najh
愻	btxn
愼	nxhw
愽	ngef
愾	nrno
愿	drin
慀	nexd
慁	lenu
慂	icen
慃	nwcn
慄	nssy
慅	ncyj
慆	nevg
慇	rvnn
慈	uxxn
慉	nyxl
慊	nuvo
態	cexn
慌	nayq
慍	nlwl
慎	nfhw
慏	npju
慐	amnu
慑	nbcc
慒	ngmj
慓	nsfi
慔	najd
慕	ajdn
慖	nlag
慗	gkin
慘	ncce
慙	lrnu
慚	nlrh
慛	nmwy
慜	txgn
慝	aadn
慞	nujh
慟	ntgl
慠	ngqt
慡	ndqq
慢	njlc
慣	nxfm
慤	fpmn
慥	ntfp
慦	fiyn
慧	dhdn
慨	nvcq
慩	nlpy
慪	nakk
慫	twwn
慬	nakg
慭	godn
慮	haln
慯	ntjr
慰	nfin
慱	ngjf
慲	namy
慳	nahf
慴	nnrg
慵	nyvh
慶	ynjt
慷	nyvi
慸	aqpn
慹	fufn
慺	nlvg
慻	nudh
慼	dhin
慽	ndht
慾	wwkn
慿	ughn
憀	nnwe
憁	ntln
憂	dept
憃	dwvn
憄	tfhn
憅	tgjn
憆	nipf
憇	tdan
憈	nhag
憉	nfke
憊	watn
憋	umin
憌	qqun
憍	ntdk
憎	nulj
憏	nwfi
憐	noqh
憑	ucnu
憒	nkhm
憓	ngjn
憔	nwyo
憕	nwgu
憖	swwn
憗	swwn
憘	nfkk
憙	fkun
憚	nkkf
憛	nsjh
憜	nbde
憝	ybtn
憞	nybt
憟	nsoy
憠	dubn
憡	ntgi
憢	nffq
憣	ntol
憤	nfam
憥	oopn
憦	nool
憧	nujf
憨	nbtn
憩	tdtn
憪	nueg
憫	nuyy
憬	njyi
憭	ndui
憮	nrlo
憯	naqj
憰	ncbk
憱	nyin
憲	pgln
憳	nvaf
憴	nxg
憵	nkun
憶	nujn
憷	nssh
憸	nwgw
憹	nmae
憺	nqdy
憻	nylg
憼	aqkn
憽	naqn
憾	ndgn
憿	nryt
懀	nwgj
懁	nlge
懂	natf
懃	akgn
懄	nakl
懅	nhae
懆	nkks
懇	eevn
懈	nqeh
應	ywwn
懊	ntmd
懋	scbn
懌	nlff
懍	nylt
懎	nfwk
懏	nwym
懐	nyle
懑	iagn
懒	ngkm
懓	nept
懔	nyli
懕	djen
懖	qtdn
懗	nfoo
懘	iaqn
懙	nwfw
懚	nean
懛	nfkf
懜	nalq
懝	nxth
懞	nape
懟	ogun
懠	nyjg
懡	nysc
懢	nahl
懣	iamn
懤	nfnf
懥	nfph
懦	nfdj
懧	npns
懨	ndjd
懩	nude
懪	njai
懫	nrrm
懬	yamn
懭	nyaw
懮	ndet
懯	gehn
懰	nqyj
懱	nalt
懲	tmgn
懳	ndhn
懴	nfag
懵	nalh
懶	ngkm
懷	nyle
懸	hitn
懹	nyke
懺	nwwg
懻	nuxw
懼	nhhy
懽	naky
懾	nbbb
懿	fpgn
戀	xyxn
戁	akfn
戂	nysd
戃	nipo
戄	nhhc
戅	ujan
戆	ujtn
戇	ujtn
戈	agnt
戉	anyt
戊	dnyt
戋	gggt
戌	dgnt
戍	dynt
戎	ade
戏	cat
成	dnnt
我	trnt
戒	aak
戓	akd
戔	aar
戕	nhda
或	akgd
戗	wbat
战	hkat
戙	mgka
戚	dhit
戛	dhar
戜	akgd
戝	mat
戞	depa
戟	fjat
戠	uajd
戡	adwa
戢	kbnt
戣	wgda
戤	ecla
戥	jtga
戦	ijfa
戧	wyva
戨	sksa
戩	gcca
截	fawy
戫	deag
戬	goga
戭	pgma
戮	nwea
戯	haoa
戰	kkja
戱	hana
戲	haga
戳	nwya
戴	falw
戵	hhwa
戶	rnd
户	yne
戸	gnr
戹	ynnv
戺	ynnn
戻	yndi
戼	nagn
戽	ynuf
戾	yndi
房	ynyv
所	rnrh
扁	ynma
扂	ynhk
扃	ynmk
扄	yntk
扅	ynqq
扆	ynye
扇	ynnd
扈	ynkc
扉	yndd
扊	ynoo
手	rtgh
扌	rghg
才	fte
扎	rnn
扏	rvn
扐	rln
扑	rhy
扒	rwy
打	rsh
扔	ren
払	rcy
扖	rtyy
扗	rfg
托	rtan
扙	rdyy
扚	rqyy
扛	rag
扜	rgfh
扝	rfnn
扞	rfh
扟	rnfh
扠	rcyy
扡	rbn
扢	rtnn
扣	rkg
扤	rgqn
扥	rtan
扦	rtfh
执	rvyy
扨	rvyy
扩	ryt
扪	run
扫	rvg
扬	rnrt
扭	rnfg
扮	rwvn
扯	rhg
扰	rdnn
扱	reyy
扲	rwyn
扳	rrcy
扴	rwjh
扵	rwuy
扶	rfwy
扷	rtdy
扸	rthn
批	rxxn
扺	rqan
扻	rqwy
扼	rdbn
扽	rgbn
找	rat
承	bdii
技	rfcy
抁	rcqn
抂	rgg
抃	ryhy
抄	ritt
抅	rqcy
抆	ryy
抇	rjg
抈	reg
抉	rnwy
把	rcn
抋	rny
抌	rpqn
抍	rtah
抎	rfcy
抏	rfqn
抐	rmwy
抑	rqbh
抒	rcbh
抓	rrhy
抔	rgiy
投	rmcy
抖	rufh
抗	rymn
折	rrh
抙	rrh
抚	rfqn
抛	rvln
抜	rdcy
抝	rxnn
択	rnyy
抟	rfny
抠	raqy
抡	rwxn
抢	rwbn
抣	rqug
护	rynt
报	rbcy
抦	rgmw
抧	rkwy
抨	rguh
抩	rmfg
抪	rdmh
披	rhcy
抬	rckg
抭	rpmn
抮	rwet
抯	regg
抰	rmdy
抱	rqnn
抲	rskg
抳	rnxn
抴	rann
抵	rqay
抶	rrwy
抷	rgig
抸	rtpy
抹	rgsy
抺	rfiy
抻	rjhh
押	rlh
抽	rmg
抾	rfcy
抿	rnan
拀	rkqn
拁	rlkg
拂	rxjh
拃	rthf
拄	rygg
担	rjgg
拆	rryy
拇	rxgu
拈	rhkg
拉	rug
拊	rwfy
拋	rdnl
拌	rufh
拍	rrg
拎	rwyc
拏	vcrj
拐	rkln
拑	rafg
拒	rang
拓	rdg
拔	rdcy
拕	rpxn
拖	rtbn
拗	rxln
拘	rqkg
拙	rbmh
拚	rcah
招	rvkg
拜	rdfh
拝	rdfh
拞	rrgg
拟	rnyw
拠	rtmn
拡	rycy
拢	rdxn
拣	ranw
拤	rhhy
拥	reh
拦	rufg
拧	rpsh
拨	rnty
择	rcfh
拪	rsg
拫	rvey
括	rtdg
拭	raag
拮	rfkg
拯	rbig
拰	rwtf
拱	rawy
拲	awrj
拳	udrj
拴	rwgg
拵	rdhb
拶	rvqy
拷	rftn
拸	rqqy
拹	rlll
拺	rgmi
拻	rdoy
拼	ruah
拽	rjxt
拾	rwgk
拿	wgkr
挀	rrey
持	rffy
挂	rffg
挃	rgcf
挄	riqn
挅	resy
挆	rmsy
指	rxjg
挈	dhvr
按	rpvg
挊	rhgh
挋	rahh
挌	rtkg
挍	ruqy
挎	rdfn
挏	rmgk
挐	vkrj
挑	riqn
挒	rgqj
挓	rpta
挔	ryey
挕	rbg
挖	rpwn
挗	rgxw
挘	ritl
挙	iwrj
挚	rvyr
挛	yorj
挜	rgog
挝	rfpy
挞	rdpy
挟	rguw
挠	ratq
挡	rivg
挢	rtdj
挣	rqvh
挤	ryjh
挥	rplh
挦	rvfy
挧	rng
挨	rctd
挩	rwkq
挪	rvfb
挫	rwwf
挬	rfpb
挭	rgjq
挮	ruxt
振	rdfe
挰	rkgg
挱	riit
挲	iitr
挳	rgva
挴	rtxu
挵	rgah
挶	rnnk
挷	rdtb
挸	rhqn
挹	rkcn
挺	rtfp
挻	rthp
挼	revg
挽	rqkq
挾	rdww
挿	rtgh
捀	rtdh
捁	rtfk
捂	rgkg
捃	rvtk
捄	rfiy
捅	rceh
捆	rlsy
捇	rfoy
捈	rwty
捉	rkhy
捊	rebg
捋	refy
捌	rklj
捍	rjfh
捎	rieg
捏	rjfg
捐	rkeg
捑	rjgy
捒	rgki
捓	rahb
捔	rqeh
捕	rgey
捖	rpfq
捗	rhit
捘	rcwt
捙	rlh
捚	rjfg
捛	rkkg
捜	rjhc
捝	rukq
捞	rapl
损	rkmy
捠	rrgw
捡	rwgi
换	rqmd
捣	rqym
捤	rntn
捥	rpqb
捦	rqg
捧	rdwh
捨	rwfk
捩	rynd
捪	rqaj
捫	rug
捬	rywf
捭	rrtf
据	rndg
捯	rgcj
捰	rjsy
捱	rdff
捲	rudb
捳	rrgm
捴	rwcn
捵	rmaw
捶	rtgf
捷	rgvh
捸	rviy
捹	rdfa
捺	rdfi
捻	rwyn
捼	rtvg
捽	rywf
捾	rpnn
捿	rgvv
掀	rrqw
掁	rdey
掂	ryhk
掃	rvph
掄	rwga
掅	rgeg
掆	rmum
掇	rccc
授	repc
掉	rhjh
掊	rukg
掋	ryqy
掌	ipkr
掍	rjxx
掎	rdsk
掏	rqrm
掐	rqvg
掑	radw
排	rdjd
掓	rhic
掔	ahnr
掕	rfwt
掖	rywy
掗	rgfg
掘	rnbm
掙	revh
掚	rgmy
掛	rffh
掜	rvqn
掝	rakg
掞	rooy
掟	rpgh
掠	ryiy
採	resy
探	rpws
掣	rmhr
掤	reeg
接	ruvg
掦	rjqr
控	rpwa
推	rwyg
掩	rdjn
措	rajg
掫	rbcy
掬	rqoy
掭	rgdn
掮	ryne
掯	rheg
掰	rwvr
掱	rrrj
掲	rjqx
掳	rhal
掴	rlgy
掵	rwgb
掶	ryvw
掷	rudb
掸	rujf
掹	rblg
掺	rcde
掻	rcjy
掼	rxfm
掽	ruog
掾	rxey
掿	radk
揀	rgli
揁	rhmy
揂	rusg
揃	ruej
揄	rwgj
揅	dgar
揆	rwgd
揇	rfmf
揈	rqyg
揉	rcbs
揊	rgkl
揋	rlge
揌	rlny
揍	rdwd
揎	rpgg
描	ralg
提	rjgh
揑	rvag
插	rtfv
揓	rytb
揔	rqrn
揕	radn
揖	rkbg
揗	rrfh
揘	rrgg
揙	ryna
揚	rjgr
換	rqmd
揜	rwga
揝	rthj
揞	rujg
揟	rnhe
揠	rajv
握	rngf
揢	rptk
揣	rmdj
揤	rvcb
揥	ruph
揦	rgkj
揧	gkir
揨	ryps
揩	rxxr
揪	rtoy
揫	torj
揬	rpwd
揭	rjqn
揮	rplh
揯	rngg
揰	rtgf
揱	iejr
揲	rans
揳	rdhd
援	refc
揵	rvfp
揶	rbbh
揷	rtgh
揸	rsjg
揹	ruxe
揺	refb
揻	rdgt
揼	rdiy
揽	rjtq
揾	rjlg
揿	rqqw
搀	rqku
搁	rutk
搂	rovg
搃	rukn
搄	rngg
搅	ripq
搆	rfjf
搇	rwye
搈	rpwk
搉	rpwy
搊	rqbt
搋	rrhm
搌	rnae
損	rkmy
搎	rbti
搏	rgef
搐	ryxl
搑	rabg
搒	rupy
搓	ruda
搔	rcyj
搕	rfcl
搖	rqrm
搗	rwvm
搘	rftj
搙	rdff
搚	rlle
搛	ruvo
搜	rvhc
搝	rthd
搞	rymk
搟	rlfh
搠	rube
搡	rccs
搢	rgoj
搣	rdgt
搤	ruwl
搥	rwnp
搦	rxuu
搧	rynn
搨	rjng
搩	rqas
搪	ryvk
搫	temr
搬	rtec
搭	rawk
搮	rssy
搯	revg
搰	rmeg
搱	rnuh
搲	rpwy
搳	rpdk
搴	pfjr
搵	rlwl
搶	rwyk
搷	rfhw
搸	rdwt
搹	rgkh
携	rwye
搻	wgkr
搼	rudr
搽	raws
搾	rpwf
搿	rwgr
摀	rwno
摁	rldn
摂	rbiy
摃	ramy
摄	rbcc
摅	rhan
摆	rlfc
摇	rerm
摈	rprw
摉	rpwq
摊	rcwy
摋	rqsc
摌	rutg
摍	rpwj
摎	rnwe
摏	rdwv
摐	rtwh
摑	rlag
摒	rnua
摓	rtdp
摔	ryxf
摕	raqh
摖	rwfi
摗	rgkw
摘	rumd
摙	rlpy
摚	ripf
摛	rybc
摜	rxfm
摝	rynx
摞	rlxi
摟	rlvg
摠	rtln
摡	rvcq
摢	rhah
摣	rhag
摤	rdqq
摥	rtjr
摦	rdfy
摧	rmwy
摨	rnih
摩	yssr
摪	rnhf
摫	rfwq
摬	rujq
摭	ryao
摮	gqtr
摯	fufr
摰	fwfr
摱	rjlc
摲	rlrh
摳	rakk
摴	rffn
摵	rdht
摶	rgjf
摷	rvjs
摸	rajd
摹	ajdr
摺	rnrg
摻	rcce
摼	rahf
摽	rsfi
摾	rxkj
摿	rwuj
撀	fnmr
撁	ryxh
撂	rltk
撃	lmcr
撄	rmmv
撅	rduw
撆	umir
撇	rumt
撈	rool
撉	ybtr
撊	rueg
撋	rugg
撌	rkhm
撍	raqj
撎	rfpu
撏	rvaf
撐	ript
撑	ripr
撒	raet
撓	rffq
撔	rjyi
撕	radr
撖	rnbt
撗	ramw
撘	rtwk
撙	rusf
撚	rqdo
撛	roqh
撜	rwgu
撝	reto
撞	rujf
撟	rtdk
撠	rfja
撡	rccn
撢	rsjh
撣	rkkf
撤	ryct
撥	rwxc
撦	rdfj
撧	rxqc
撨	rwyo
撩	rdui
撪	rcdl
撫	rrlo
撬	rtfn
播	rtol
撮	rjbc
撯	rudh
撰	rnnw
撱	rbde
撲	rogy
撳	rqqw
撴	rybt
撵	rfwl
撶	ragf
撷	rfkm
撸	rqgj
撹	ripq
撺	rpwh
撻	rfup
撼	rdgn
撽	rryt
撾	rmnp
撿	rwgw
擀	rfjf
擁	ryxy
擂	rflg
擃	rmae
擄	rhal
擅	rylg
擆	rafj
擇	rlff
擈	rogw
擉	rlqj
擊	lbmr
擋	ripl
擌	rtdw
操	rkks
擎	aqkr
擏	raqt
擐	rlge
擑	rkbt
擒	rwyc
擓	raiy
擔	rqdy
擕	rwym
擖	rajn
擗	rnku
擘	nkur
擙	rtmd
據	rhae
擛	raas
擜	rfmd
擝	rjel
擞	rovt
擟	rgwq
擠	ryjg
擡	rfkf
擢	rnwy
擣	rfnf
擤	rthj
擥	ahnr
擦	rpwi
擧	wfgr
擨	rrhw
擩	rfdj
擪	djer
擫	rdjd
擬	rxth
擭	rawc
擮	rfay
擯	rpgm
擰	rpns
擱	rutk
擲	rusb
擳	rtvb
擴	ryaw
擵	rysr
擶	rtuj
擷	rfkm
擸	rvln
擹	rakw
擺	rlcx
擻	rlvt
擼	rqoj
擽	rxrs
擾	rdet
擿	rump
攀	sqqr
攁	rude
攂	rlll
攃	rawi
攄	rhan
攅	rfwm
攆	rfwl
攇	rpdn
攈	rynt
攉	rfwy
攊	rdth
攋	rgkm
攌	rlle
攍	ryny
攎	rhal
攏	rued
攐	rpfe
攑	rwfh
攒	rtfm
攓	rpfh
攔	rugi
攕	rwwg
攖	rmmv
攗	ryno
攘	ryke
攙	rqky
攚	rook
攛	rpwn
攜	rmwk
攝	rbbb
攞	rlxy
攟	rynt
攠	rysd
攡	ryby
攢	rtfm
攣	xyxr
攤	raky
攥	rthi
攦	rgmx
攧	rfhm
攨	rpwy
攩	ripo
攪	rwfq
攫	rhhc
攬	rahq
攭	rxej
攮	rgke
支	fcu
攰	fclv
攱	ufcy
攲	dskc
攳	fcvf
攴	hcu
攵	ttgy
收	nhty
攷	gnty
攸	whty
改	nty
攺	nty
攻	aty
攼	fty
攽	wvty
放	yty
政	ghty
敀	rty
敁	hkhc
敂	qkty
敃	naty
敄	cbtt
故	dty
敆	wgkc
敇	gmit
效	uqty
敉	oty
敊	hihc
敋	tkty
敌	tdty
敍	wthc
敎	qdbt
敏	txgt
敐	dfet
救	fiyt
敒	wjht
敓	wkqt
敔	gkty
敕	gkit
敖	gqty
敗	mty
敘	wtty
教	ftbt
敚	ukqt
敛	wgit
敜	wynt
敝	umit
敞	imkt
敟	mawt
敠	cccc
敡	jqrc
敢	nbty
散	aety
敤	jshc
敥	oohc
敦	ybty
敧	dskc
敨	ukty
敩	ipbt
敪	ccct
敫	ryty
敬	aqkt
敭	jgqt
敮	tfvc
敯	najc
数	ovty
敱	mgkc
敲	ymkc
敳	mgkt
整	gkih
敵	umdt
敶	bgjt
敷	geht
數	lvty
敹	hptt
敺	akkc
敻	qmwt
敼	fkuc
敽	tdkc
敾	udut
敿	tdkt
斀	lqjc
斁	lfut
斂	wgkt
斃	umix
斄	fitw
斅	wfqc
斆	wfqt
文	yygy
斈	ybf
斉	yjf
斊	ybf
斋	ydmj
斌	ygah
斍	yhqb
斎	yfij
斏	yyve
斐	djdy
斑	gygg
斒	yyna
斓	yugi
斔	yjvw
斕	yugi
斖	ywfg
斗	ufk
斘	qufh
料	oufh
斚	ccpf
斛	qeuf
斜	wtuf
斝	kkpf
斞	vwuf
斟	adwf
斠	fjgf
斡	fjwf
斢	amwf
斣	lqjf
斤	rtth
斥	ryi
斦	rrh
斧	wqrj
斨	nhdr
斩	lrh
斪	qkrh
斫	drh
斬	lrh
断	onrh
斮	ajrh
斯	adwr
新	usrh
斱	ftjr
斲	anfr
斳	akgr
斴	oqar
斵	qyvr
斶	rlqj
斷	xxgr
斸	nilr
方	yygn
斺	ywjh
斻	ytmn
於	ywuy
施	ytbn
斾	ytmh
斿	ytbg
旀	yciy
旁	upyb
旂	ytrh
旃	ytmy
旄	yttn
旅	ytey
旆	ytgh
旇	ythc
旈	yycq
旉	gehy
旊	ytgn
旋	ytnh
旌	yttg
旍	ytwc
旎	ytnx
族	yttd
旐	ytiq
旑	ydsk
旒	ytyq
旓	ytie
旔	yvfp
旕	ywux
旖	ytdk
旗	ytaw
旘	yuaj
旙	ytol
旚	ytsi
旛	yttl
旜	ytyg
旝	ytwj
旞	ytup
旟	ytww
无	fqv
旡	aqv
既	vcaq
旣	rxaq
旤	mnmq
日	jjjj
旦	jgf
旧	hjg
旨	xjf
早	jhnh
旪	jfh
旫	jvn
旬	qjd
旭	vjd
旮	vjf
旯	jvb
旰	jfh
旱	jfj
旲	jdu
旳	jqyy
旴	jgfh
旵	jmj
时	jfy
旷	jyt
旸	jnrt
旹	bhgj
旺	jgg
旻	jyu
旼	jyy
旽	jgbn
旾	gbnj
旿	jtfh
昀	jqug
昁	jgmh
昂	jqbj
昃	jdwu
昄	jrcy
昅	jeyy
昆	jxxb
昇	jtaj
昈	jynt
昉	jyn
昊	jgdu
昋	gdjf
昌	jjf
昍	jjg
明	jeg
昏	qajf
昐	jwvn
昑	jwyn
昒	jqrt
易	jqrr
昔	ajf
昕	jrh
昖	jwcy
昗	juu
昘	jyb
昙	jfcu
昚	dujf
昛	jang
昜	jgqr
昝	thjf
昞	jgmw
星	jtgf
映	jmdy
昡	jyxy
昢	jbmh
昣	jwet
昤	jwyc
春	dwjf
昦	jdjj
昧	jfiy
昨	jthf
昩	jgsy
昪	jcaj
昫	jqkg
昬	najf
昭	jvkg
昮	jalb
是	jghu
昰	jghf
昱	juf
昲	jxjh
昳	jrwy
昴	jqtb
昵	jnxn
昶	ynij
昷	jlf
昸	jtuy
昹	jyni
昺	jgmw
昻	jabj
昼	nyjg
昽	jdxn
显	jogf
昿	jycy
晀	jiqn
晁	jiqb
時	jffy
晃	jiqb
晄	jiqn
晅	jgjg
晆	jffg
晇	jdfn
晈	juqy
晉	gccj
晊	jgcf
晋	gogj
晌	jtmk
晍	jmgk
晎	jawy
晏	jpvf
晐	jynw
晑	jtmk
晒	jsg
晓	jatq
晔	jwxf
晕	jplj
晖	jplh
晗	jwyk
晘	jjfh
晙	jcwt
晚	jqkq
晛	jhqn
晜	juxt
晝	vfjg
晞	jqdh
晟	jdnt
晠	jdnt
晡	jgey
晢	rrjf
晣	jrrh
晤	jgkg
晥	jpfq
晦	jtxu
晧	jtfk
晨	jdfe
晩	jqjq
晪	jmaw
晫	jhjh
晬	jywf
晭	jmfk
普	uogj
景	jyiu
晰	jsrh
晱	jooy
晲	jvqn
晳	srjf
晴	jgeg
晵	yntj
晶	jjjf
晷	jthk
晸	jght
晹	jjqr
智	tdkj
晻	jdjn
晼	jpqb
晽	jssy
晾	jyiy
晿	jjjg
暀	jtyg
暁	jfaq
暂	lrjf
暃	jdjd
暄	jpgg
暅	jngg
暆	jytb
暇	jnhc
暈	jplj
暉	jplh
暊	jdmy
暋	natj
暌	jwgd
暍	jjqn
暎	jamd
暏	jftj
暐	jnhh
暑	jftj
暒	jjtg
暓	cbtj
暔	jfmf
暕	jgli
暖	jefc
暗	jujg
暘	jjgr
暙	jdwj
暚	jerm
暛	juda
暜	uujf
暝	jpju
暞	jths
暟	jmgu
暠	jymk
暡	jwcn
暢	jhjr
暣	jrno
暤	jrdf
暥	jjpv
暦	dssj
暧	jepc
暨	vcag
暩	jwfi
暪	jamy
暫	lrjf
暬	fwfj
暭	jrif
暮	ajdj
暯	jajd
暰	jtwh
暱	jaak
暲	jujh
暳	jdhv
暴	jawi
暵	jakw
暶	jyth
暷	jgjf
暸	jdui
暹	jwyp
暺	jkkf
暻	jjyi
暼	umij
暽	joqh
暾	jybt
暿	jfkk
曀	jfpu
曁	rxag
曂	jamw
曃	jvip
曄	jagf
曅	jagh
曆	dttj
曇	jffc
曈	jujf
曉	jffq
曊	jxjm
曋	jsjh
曌	jepa
曍	jthf
曎	jlff
曏	jxtb
曐	jjjg
曑	jjje
曒	jryt
曓	jbmf
曔	jaqt
曕	jqdy
曖	jept
曗	jogw
曘	jfdj
曙	jlfj
曚	jape
曛	jtgo
曜	jnwy
曝	jjai
曞	jday
曟	jjje
曠	jyaw
曡	jjjg
曢	jpdi
曣	jauo
曤	jfwy
曥	jhal
曦	jugt
曧	jgkj
曨	jued
曩	jyke
曪	jlxy
曫	xyxj
曬	jgmx
曭	jipo
曮	jkkt
曯	jnij
曰	jhng
曱	jhk
曲	mad
曳	jxe
更	gjqi
曵	jxyi
曶	qrjf
曷	jqwn
書	vfjf
曹	gmaj
曺	gmjf
曻	jqah
曼	jlcu
曽	uljf
曾	uljf
替	fwfj
最	jbcu
朁	aqaj
朂	jblb
會	wglj
朄	jhgi
朅	fcjn
朆	uljr
朇	wglf
月	eeee
有	def
朊	efqn
朋	eeg
朌	ewvn
服	ebcy
朎	ewyc
朏	ebmh
朐	eqkg
朑	eann
朒	emww
朓	eiqn
朔	ubte
朕	eudy
朖	eyve
朗	yvce
朘	ecwt
朙	lwme
朚	ynje
望	yneg
朜	eybg
朝	fjeg
朞	adwe
期	adwe
朠	eamd
朡	eqbt
朢	ahng
朣	eujf
朤	eeee
朥	eool
朦	eape
朧	eued
木	ssss
朩	sghy
未	fii
末	gsi
本	sgd
札	snn
朮	fqyi
术	syi
朰	snb
朱	rii
朲	swy
朳	swy
朴	shy
朵	msu
朶	esu
朷	svn
朸	sln
朹	svn
机	smn
朻	snhh
朼	sxn
朽	sgnn
朾	ssh
朿	gmii
杀	qsu
杁	styy
杂	vsu
权	scy
杄	stfh
杅	sgfh
杆	sfh
杇	sfnn
杈	scyy
杉	set
杊	skh
杋	smyy
杌	sgqn
杍	sbg
李	sbf
杏	skf
材	sftt
村	sfy
杒	svyy
杓	sqyy
杔	stan
杕	sdy
杖	sdyy
杗	ynsu
杘	nsi
杙	say
杚	stnn
杛	sxn
杜	sfg
杝	sbn
杞	snn
束	gkii
杠	sag
条	tsu
杢	saf
杣	smh
杤	sdnn
来	goi
杦	sqyy
杧	synn
杨	snrt
杩	scg
杪	sitt
杫	shg
杬	sfqn
杭	symn
杮	sgmh
杯	sgiy
杰	sou
東	gjii
杲	jsu
杳	sjf
杴	sqwy
杵	stfh
杶	sgbn
杷	scn
杸	smcy
杹	swxn
杺	sny
杻	snfg
杼	scbh
杽	srh
松	swcy
板	srcy
枀	wcsu
极	seyy
枂	seg
枃	squg
构	sqcy
枅	sgah
枆	stfn
枇	sxxn
枈	xxsu
枉	sgg
枊	sqbh
枋	syn
枌	swvn
枍	swgn
枎	sfwy
枏	smfg
析	srh
枑	sgxg
枒	saht
枓	sufh
枔	swyn
枕	spqn
枖	stdy
林	ssy
枘	smwy
枙	sdbn
枚	sty
枛	srhy
果	jsi
枝	sfcy
枞	swwy
枟	sfcy
枠	svfh
枡	stah
枢	saqy
枣	gmiu
枤	sdy
枥	sdln
枦	synt
枧	smqn
枨	stay
枩	swcu
枪	swbn
枫	smqy
枬	smyg
枭	qyns
枮	shkg
枯	sdg
枰	gudn
枱	sckg
枲	cksu
枳	skwy
枴	skvn
枵	skgn
架	lksu
枷	slkg
枸	sqkg
枹	sqnn
枺	sgsy
枻	sann
枼	ansu
枽	fasu
枾	sfjg
枿	sfah
柀	shcy
柁	spxn
柂	stbn
柃	swyc
柄	sgmw
柅	snxn
柆	sug
柇	sty
柈	sufh
柉	stpy
柊	stuy
柋	wasu
柌	sngk
柍	smdy
柎	swfy
柏	srg
某	afsu
柑	safg
柒	iasu
染	ivsu
柔	cbts
柕	scbt
柖	svkg
柗	swkg
柘	sdg
柙	slh
柚	smg
柛	sjhh
柜	sang
柝	sryy
柞	sthf
柟	smfg
柠	spsh
柡	sfiy
柢	sqay
柣	srwy
柤	segg
查	sjgf
柦	sjgg
柧	srcy
柨	sdmh
柩	saqy
柪	sxln
柫	sxjh
柬	glii
柭	sdcy
柮	sbmh
柯	sskg
柰	sfiu
柱	sygg
柲	sntt
柳	sqtb
柴	hxsu
柵	smah
柶	slg
柷	skqn
柸	sgig
柹	stnt
柺	skln
査	segf
柼	spwy
柽	scfg
柾	sghg
柿	symh
栀	srgb
栁	sqbh
栂	sxgu
栃	srdn
栄	ipsu
栅	smmg
栆	gkhu
标	sfiy
栈	sgt
栉	sabh
栊	sdxn
栋	saiy
栌	shnt
栍	stgg
栎	sqiy
栏	sufg
栐	syni
树	scfy
栒	sqjg
栓	swgg
栔	dhvs
栕	sahh
栖	ssg
栗	ssu
栘	sqqy
栙	stah
栚	sudy
栛	slll
栜	sgmi
栝	stdg
栞	ftfs
栟	suah
栠	wtfs
校	suqy
栢	sdjg
栣	swtf
栤	suiy
栥	uqws
栦	syth
栧	sjxt
栨	suqw
栩	sng
株	sriy
栫	sdhb
栬	sqcn
栭	sdmj
栮	sbg
栯	sdeg
栰	swat
栱	sawy
栲	sftn
栳	sftx
栴	stmy
栵	sgqj
栶	sldy
样	sudh
核	synw
根	svey
栺	sxjg
栻	eeee
格	stkg
栽	fasi
栾	yosu
栿	swdy
桀	qahs
桁	stfh
桂	sffg
桃	siqn
桄	siqn
桅	sqdb
框	sagg
桇	vksu
案	pvsu
桉	spvg
桊	udsu
桋	sgxw
桌	hjsu
桍	sdfn
桎	sgcf
桏	sabh
桐	smgk
桑	cccs
桒	fasu
桓	sgjg
桔	sfkg
桕	svg
桖	stlg
桗	sesy
桘	swnn
桙	scrh
桚	svqy
桛	shgh
桜	sivg
桝	sqah
桞	sqbh
桟	sdxy
桠	sgog
桡	satq
桢	shmy
档	sivg
桤	smnn
桥	stdj
桦	swxf
桧	swfc
桨	uqsu
桩	syfg
桪	svfy
桫	siit
桬	iits
桭	sdfe
桮	sgik
桯	skgg
桰	sqak
桱	sgva
桲	sfpb
桳	scdf
桴	sebg
桵	sevg
桶	sceh
桷	sqeh
桸	sqdh
桹	syve
桺	sgan
桻	stdh
桼	swiu
桽	swwf
桾	svtk
桿	sjfh
梀	sgki
梁	ivws
梂	sfiy
梃	stfp
梄	ssgg
梅	stxu
梆	sdtb
梇	sgah
梈	sybh
梉	snhf
梊	rrsu
梋	skeg
梌	swty
梍	sran
梎	srxn
梏	stfk
梐	sxxf
梑	sqto
梒	swyk
梓	suh
梔	srgc
梕	svyn
梖	smy
梗	sgjq
梘	shqn
梙	skkh
梚	sqkq
梛	svfb
梜	sdww
條	whts
梞	snny
梟	wvgs
梠	skkg
梡	spfq
梢	sieg
梣	smwn
梤	smwv
梥	pwcs
梦	ssqu
梧	sgkg
梨	tjsu
梩	sjfg
梪	sgku
梫	svpc
梬	smgn
梭	scwt
梮	snnk
梯	suxt
械	saah
梱	slsy
梲	swkq
梳	sycq
梴	sthp
梵	ssmy
梶	sntn
梷	hkcs
梸	stjh
梹	srgw
梺	ssgh
梻	swxj
梼	sdtf
梽	sfny
梾	sgoy
梿	slpy
检	swgi
棁	sukq
棂	svoy
棃	tqts
棄	ycas
棅	stgi
棆	swga
棇	swcn
棈	sgeg
棉	srmh
棊	adws
棋	sadw
棌	sesy
棍	sjxx
棎	spws
棏	sjgf
棐	djds
棑	sdjd
棒	sdwh
棓	sukg
棔	sqaj
棕	spfi
棖	sdey
棗	gmii
棘	gmii
棙	synd
棚	seeg
棛	syce
棜	sywu
棝	sldg
棞	slty
棟	sgji
棠	ipks
棡	smum
棢	smun
棣	sviy
棤	sajg
棥	sqqs
棦	sqvh
棧	saat
棨	ynts
棩	sjgg
棪	sooy
棫	sakg
棬	sudb
棭	sywy
森	sssu
棯	swyn
棰	stgf
棱	sfwt
棲	sgvv
棳	sccc
棴	sebc
棵	sjsy
棶	ssww
棷	sbcy
棸	bcsu
棹	shjh
棺	spnn
棻	awvs
棼	sswv
棽	sswn
棾	sspm
棿	svqn
椀	spqb
椁	sybg
椂	sviy
椃	sham
椄	suvg
椅	sdsk
椆	smfk
椇	shwy
椈	sqoy
椉	yqas
椊	sywf
椋	syiy
椌	spwa
植	sfhg
椎	swyg
椏	sgfg
椐	sndg
椑	srtf
椒	shic
椓	seyy
椔	svlg
椕	swvs
椖	syny
椗	spgh
椘	sspu
椙	sjjg
椚	sug
椛	sawx
検	swgw
椝	fwms
椞	srsu
椟	sfnd
椠	lrsu
椡	sgcj
椢	slgy
椣	smaw
椤	slqy
椥	stdk
椦	sudl
椧	swgb
椨	sywf
椩	syvw
椪	suog
椫	sujf
椬	speg
椭	sbde
椮	scde
椯	smdj
椰	sbbh
椱	stjt
椲	snhh
椳	slge
椴	swdc
椵	snhc
椶	sqbt
椷	sdgt
椸	sytb
椹	sadn
椺	swks
椻	sajv
椼	stih
椽	sxey
椾	suej
椿	sdwj
楀	stky
楁	sptk
楂	ssjg
楃	sngf
楄	syna
楅	sgkl
楆	ssvg
楇	smnk
楈	snhe
楉	sadk
楊	sjgr
楋	sgkj
楌	sute
楍	skkk
楎	splh
楏	sdff
楐	slwj
楑	swgd
楒	slny
楓	smtj
楔	sdhd
楕	sdae
楖	svcb
楗	svfp
楘	cbts
楙	scbs
楚	ssnh
楛	sadg
楜	sdeg
楝	sgli
楞	slyn
楟	syps
楠	sfmf
楡	swgb
楢	susg
楣	snhg
楤	sqrn
楥	sefc
楦	spgg
楧	samd
楨	shmy
楩	swgq
楪	sans
楫	skbg
楬	sjqn
業	oguw
楮	sftj
楯	srfh
楰	svwy
楱	sdwd
楲	sdgt
楳	safs
楴	suph
極	sbkg
楶	uqws
楷	sxxr
楸	stoy
楹	secl
楺	scbs
楻	srgg
楼	sovg
楽	risu
楾	sriy
楿	stjg
榀	skkk
榁	spgf
概	svcq
榃	sslf
榄	sjtq
榅	sjlg
榆	swgj
榇	susy
榈	sukk
榉	siwh
榊	spyh
榋	svvv
榌	snuh
榍	snie
榎	sdht
榏	suwl
榐	snae
榑	sgef
榒	sxuu
榓	sntl
榔	syvb
榕	spwk
榖	fptc
榗	sgoj
榘	tdas
榙	sawk
榚	sugo
榛	sdwt
榜	supy
榝	sqsc
榞	sdri
榟	spuh
榠	spju
榡	sgxi
榢	spey
榣	serm
榤	sqas
榥	sjiq
榦	fjws
榧	sadd
榨	spwf
榩	shay
榪	scy
榫	swyf
榬	sfke
榭	stmf
榮	oops
榯	sjff
榰	sftj
榱	syke
榲	slwl
榳	sytp
榴	sqyl
榵	sabg
榶	syvk
榷	spwy
榸	sfjf
榹	srhm
榺	euds
榻	sjng
榼	sfcl
榽	sexd
榾	smeg
榿	smgu
槀	ymks
槁	symk
槂	sbti
槃	tems
槄	sevg
槅	sgkh
槆	saqj
槇	sxhw
槈	sdff
槉	sutd
槊	ubts
構	sfjf
槌	swnp
槍	swyk
槎	suda
槏	suvo
槐	srqc
槑	ksks
槒	syxl
槓	samy
槔	srdf
槕	shjs
槖	fpds
槗	sdkk
様	sugi
槙	sfhw
槚	ssmy
槛	sjtl
槜	swye
槝	swvm
槞	sujn
槟	sprw
槠	syfj
槡	sccs
槢	snrg
槣	spdk
槤	slpy
槥	sdhv
槦	syvh
槧	lrsu
槨	sybb
槩	rxas
槪	srxq
槫	sgjf
槬	sdfy
槭	sdht
槮	scce
槯	smwy
槰	stdp
槱	ssgo
槲	sqef
槳	nhds
槴	sync
槵	skkn
槶	slag
槷	fwfs
槸	sfwy
槹	srif
槺	syvi
槻	sfwq
槼	fwhs
槽	sgmj
槾	sjlc
槿	sakg
樀	sumd
樁	sdwv
樂	xrxs
樃	syve
樄	sbgi
樅	stwh
樆	sybc
樇	swhe
樈	sujq
樉	sdqq
樊	sqqd
樋	scep
樌	sxfm
樍	sgmy
樎	spwj
樏	slxi
樐	shlo
樑	sivs
樒	spnm
樓	slvg
樔	svjs
樕	sgkw
樖	wgkk
樗	sffn
樘	sipf
標	ssfi
樚	synx
樛	snwe
樜	syao
樝	shag
樞	sakk
樟	sujh
樠	samy
模	sajd
樢	swvo
樣	sugi
樤	swhs
樥	sath
樦	styg
樧	sqsc
樨	snih
権	stdy
横	samw
樫	sahf
樬	stln
樭	sadf
樮	sgjo
樯	sfuk
樰	sfvg
樱	smmv
樲	safm
樳	svaf
樴	suaj
樵	swyo
樶	sjbc
樷	ssbc
樸	sogy
樹	sfkf
樺	sagf
樻	skhm
樼	snbb
樽	susf
樾	sfht
樿	skkf
橀	sycl
橁	stqj
橂	susd
橃	swxc
橄	snbt
橅	srlo
橆	rlgs
橇	stfn
橈	sffq
橉	soqh
橊	sgal
橋	stdk
橌	sueg
橍	sugg
橎	stol
橏	sudk
橐	gkhs
橑	sdui
橒	sffc
橓	seph
橔	sybt
橕	sipt
橖	sips
橗	saje
橘	scbk
橙	swgu
橚	svfj
橛	sduw
橜	dubs
橝	ssjh
橞	sgjn
機	sxxt
橠	syqe
橡	sqje
橢	sbde
橣	spne
橤	nnns
橥	qtfs
橦	sujf
橧	sulj
橨	sfam
橩	soof
橪	sqdo
橫	sagw
橬	saqj
橭	sduh
橮	sqym
橯	sool
橰	sthf
橱	sdgf
橲	sfkk
橳	seul
橴	shxi
橵	saet
橶	sfja
橷	surq
橸	sjjj
橹	sqgj
橺	sujg
橻	snff
橼	sxxe
橽	sfup
橾	skks
橿	sglg
檀	sylg
檁	sylt
檂	smae
檃	beas
檄	sryt
檅	shdt
檆	sook
檇	swym
檈	slge
檉	sbkg
檊	sfjf
檋	sawl
檌	sldd
檍	sujn
檎	swyc
檏	sogw
檐	sqdy
檑	sflg
檒	ssmj
檓	svac
檔	sipl
檕	lbms
檖	suep
檗	nkus
檘	snku
檙	shnn
檚	sssh
檛	smnp
檜	swgj
檝	skbt
檞	sqeh
檟	ssmy
檠	aqks
檡	slff
檢	swgw
檣	sfwk
檤	sutp
檥	sugt
檦	ssfj
檧	saqn
檨	sugw
檩	syli
檪	sris
檫	spwi
檬	sape
檭	sqve
檮	sfnf
檯	sfkf
檰	sxrh
檱	staw
檲	slgf
檳	spgm
檴	sawc
檵	sxxn
檶	sdak
檷	sgwq
檸	spns
檹	sytk
檺	sype
檻	sahl
檼	sean
檽	sfdj
檾	oops
檿	djes
櫀	sadi
櫁	spnj
櫂	snwy
櫃	sakm
櫄	stgo
櫅	syjg
櫆	srqf
櫇	shcm
櫈	swgm
櫉	sdff
櫊	sutk
櫋	sthy
櫌	sdet
櫍	srrm
櫎	syaw
櫏	ssdp
櫐	llls
櫑	slll
櫒	sawi
櫓	sqoj
櫔	sday
櫕	sfwm
櫖	shan
櫗	salt
櫘	sdhn
櫙	saak
櫚	sukk
櫛	stvb
櫜	gkhs
櫝	sflm
櫞	sxxe
櫟	sxrs
櫠	sywc
櫡	stfj
櫢	slvt
櫣	salp
櫤	stuj
櫥	syff
櫦	synt
櫧	syfj
櫨	shal
櫩	suqv
櫪	sdth
櫫	efts
櫬	susq
櫭	svcg
櫮	sgkk
櫯	sqot
櫰	syle
櫱	btws
櫲	scbe
櫳	sued
櫴	sgkm
櫵	sawo
櫶	spdn
櫷	stxg
櫸	swfh
櫹	savj
櫺	sfkk
櫻	smmv
櫼	swwg
櫽	beas
櫾	seri
櫿	sook
欀	syke
欁	smas
欂	saif
欃	sqky
欄	sugi
欅	swfr
欆	swyc
欇	sbbb
欈	smwk
欉	sogc
權	saky
欋	shhy
欌	sadt
欍	sawv
欎	sqqf
欏	slxy
欐	sgmx
欑	stfm
欒	xyxs
欓	sipo
欔	shhc
欕	skkt
欖	sahq
欗	saui
欘	snij
欙	slli
欚	sxej
欛	sfae
欜	sgke
欝	sqqf
欞	sfkw
欟	sakq
欠	qwu
次	uqwy
欢	cqwy
欣	rqwy
欤	gngw
欥	jqwy
欦	wynw
欧	aqqw
欨	qkqw
欩	vkqw
欪	bmqw
欫	rhqw
欬	yntw
欭	ldqw
欮	ubtw
欯	fkqw
欰	tlqw
欱	wgkw
欲	wwkw
欳	hmaw
欴	yvcw
欵	xtdw
欶	gkiw
欷	qdmw
欸	ctdw
欹	dskw
欺	adww
欻	ooqw
欼	cccw
欽	qqwy
款	ffiw
欿	qvqw
歀	sfiw
歁	adww
歂	mdmw
歃	tfvw
歄	mnmw
歅	sfqw
歆	ujqw
歇	jqww
歈	wgew
歉	uvow
歊	ymkw
歋	rhaw
歌	sksw
歍	wngw
歎	akfw
歏	akgw
歐	akkw
歑	hatw
歒	umdw
歓	tdhw
歔	haow
歕	famw
歖	fkuw
歗	vfjw
歘	ooow
歙	wgkw
歚	uduw
歛	wgkw
歜	lqjw
歝	lfuw
歞	jxxw
歟	wfgw
歠	cccw
歡	akkw
止	hhhg
正	ghd
此	hxn
步	hir
武	gahd
歧	hfcy
歨	hhu
歩	hitr
歪	gigh
歫	hang
歬	hteu
歭	hffy
歮	hhhf
歯	hobj
歰	vyvh
歱	htgf
歲	hdgt
歳	hdgt
歴	dssh
歵	hgmy
歶	hxjy
歷	dtth
歸	wnnh
歹	gqi
歺	hqu
死	gqxb
歼	gqtf
歽	gqrh
歾	gqqr
歿	gqqc
殀	gqtd
殁	gqmc
殂	gqeg
殃	gqmd
殄	gqwe
殅	gqtg
殆	gqck
殇	gqtr
殈	gqtl
殉	gqqj
殊	gqri
残	gqgt
殌	gqga
殍	gqeb
殎	gqdw
殏	gqfy
殐	gqgi
殑	gqdq
殒	gqkm
殓	gqwi
殔	gqvi
殕	gquk
殖	gqfh
殗	gqdn
殘	gqaa
殙	gqqj
殚	gquf
殛	gqbg
殜	gqas
殝	gqdt
殞	gqkm
殟	gqjl
殠	gqtd
殡	gqpw
殢	gqah
殣	gqag
殤	gqtr
殥	gqpw
殦	gqwo
殧	gqyn
殨	gqkm
殩	gqho
殪	gqfu
殫	gqkf
殬	gqlf
殭	gqgg
殮	gqww
殯	gqpm
殰	gqfm
殱	gqfg
殲	gqwg
殳	mcu
殴	aqmc
段	wdmc
殶	ygmc
殷	rvnc
殸	fnmc
殹	atdc
殺	qsmc
殻	fpmc
殼	fpgc
殽	qdec
殾	ftjc
殿	nawc
毀	vfmc
毁	vamc
毂	fplc
毃	ymkc
毄	lkmc
毅	uemc
毆	akkc
毇	vomc
毈	qytc
毉	atdw
毊	fnmk
毋	xde
毌	xfk
母	xgui
毎	txfj
每	txgu
毐	fxdr
毑	xgub
毒	gxgu
毓	txgq
比	xxn
毕	xxfj
毖	xxnt
毗	lxxn
毘	lxxb
毙	xxgx
毚	qkxy
毛	tfnv
毜	tfni
毝	tfne
毞	xxtn
毟	ittn
毠	lktn
毡	tfnk
毢	tfns
毣	ntfn
毤	wcqn
毥	tfnj
毦	btfn
毧	tfnd
毨	tfnq
毩	tfno
毪	tfnh
毫	yptn
毬	tfny
毭	gkun
毮	ritn
毯	tfno
毰	tfnk
毱	tfno
毲	cccn
毳	tfnn
毴	tfnd
毵	cden
毶	tfne
毷	jhtn
毸	tfnn
毹	wgen
毺	tfnj
毻	daen
毼	jqwn
毽	tfnp
毾	jntn
毿	cccn
氀	lvtn
氁	tfnd
氂	fitn
氃	ujfn
氄	cbtn
氅	imkn
氆	tfnj
氇	tfnj
氈	ylkn
氉	kkkn
氊	tfng
氋	apgn
氌	tfnj
氍	hhwn
氎	llln
氏	qav
氐	qayi
民	nav
氒	qafj
氓	ynna
气	rnb
氕	rntr
氖	rneb
気	rnqu
氘	rnjj
氙	rnmj
氚	rnkj
氛	rnwv
氜	rnjf
氝	rnmw
氞	rngw
氟	rnxj
氠	rnjh
氡	rntu
氢	rnca
氣	rnou
氤	rnld
氥	rnsf
氦	rnyw
氧	rnud
氨	rnpv
氩	rngg
氪	rndq
氫	rnga
氬	rngg
氭	rngi
氮	rnoo
氯	rnvi
氰	rnge
氱	rnjr
氲	rnjl
氳	rnll
水	iiii
氵	iyyg
氶	bii
氷	yii
永	ynii
氹	nii
氺	ihyy
氻	iln
氼	iwu
氽	wiu
氾	ibn
氿	ivn
汀	ish
汁	ifh
求	fiyi
汃	iwy
汄	iwy
汅	ignn
汆	tyiu
汇	ian
汈	ingg
汉	icy
汊	icyy
汋	iqyy
汌	ikh
汍	ivyy
汎	imyy
汏	idy
汐	iqy
汑	itan
汒	iynn
汓	ibg
汔	itnn
汕	imh
汖	miu
汗	ifh
汘	itfh
汙	igfh
汚	ifnn
汛	infh
汜	inn
汝	ivg
汞	aiu
江	iag
池	ibn
污	ifnn
汢	ifg
汣	iqyy
汤	inrt
汥	ifcy
汦	iqan
汧	igah
汨	ijg
汩	ijg
汪	igg
汫	ifjh
汬	fjiu
汭	imwy
汮	iqug
汯	idcy
汰	idyy
汱	idy
汲	ieyy
汳	ircy
汴	iyhy
汵	iwyn
汶	iyy
汷	ity
汸	iyn
汹	iqbh
決	inwy
汻	itfh
汼	irhh
汽	irnn
汾	iwvn
汿	icbh
沀	icbh
沁	iny
沂	irh
沃	itdy
沄	ifcy
沅	ifqn
沆	iymn
沇	icqn
沈	ipqn
沉	ipmn
沊	pqii
沋	idnn
沌	igbn
沍	igxg
沎	iwxn
沏	iavn
沐	isy
沑	infg
沒	iqcy
沓	ijf
沔	ighn
沕	iqrt
沖	ikhh
沗	gdiu
沘	ixxn
沙	iitt
沚	ihg
沛	igmh
沜	ithn
沝	iiy
沞	igmh
沟	iqcy
沠	irhy
没	imcy
沢	inyy
沣	idhh
沤	iaqy
沥	idln
沦	iwxn
沧	iwbn
沨	imqy
沩	iyly
沪	iynt
沫	igsy
沬	ifiy
沭	isyy
沮	iegg
沯	idf
沰	idg
沱	ipxn
沲	itbn
河	iskg
沴	iwet
沵	iqiy
沶	ifiy
沷	idcy
沸	ixjh
油	img
沺	ilg
治	ickg
沼	ivkg
沽	idg
沾	ihkg
沿	imkg
泀	ingk
況	ikqn
泂	imkg
泃	iqkg
泄	iann
泅	ilwy
泆	irwy
泇	ilkg
泈	ituy
泉	riu
泊	irg
泋	ifah
泌	intt
泍	isgg
泎	ithf
泏	ibmh
泐	ibln
泑	ixln
泒	ircy
泓	ixcy
泔	iafg
法	ifcy
泖	iqtb
泗	ilg
泘	ituh
泙	iguh
泚	ihxn
泛	itpy
泜	iqay
泝	iryy
泞	ipsh
泟	ighg
泠	iwyc
泡	iqnn
波	ihcy
泣	iug
泤	inyw
泥	inxn
泦	invn
泧	iant
注	iygg
泩	itgg
泪	ihg
泫	iyxy
泬	ipwy
泭	iwfy
泮	iufh
泯	inan
泰	dwiu
泱	imdy
泲	itnt
泳	iyni
泴	ilf
泵	diu
泶	ipiu
泷	idxn
泸	ihnt
泹	ijgg
泺	iqiy
泻	ipgg
泼	inty
泽	icfh
泾	icag
泿	ivey
洀	itey
洁	ifkg
洂	iyoy
洃	idoy
洄	ilkg
洅	igmf
洆	ibig
洇	ildy
洈	iqdb
洉	irgk
洊	idhb
洋	iudh
洌	igqj
洍	iahh
洎	ithg
洏	idmj
洐	itfh
洑	iwdy
洒	isg
洓	igmi
洔	iffy
洕	iweg
洖	ikgd
洗	itfq
洘	iftn
洙	iriy
洚	itah
洛	itkg
洜	tkiu
洝	ipvg
洞	imgk
洟	igxw
洠	icrh
洡	idiy
洢	iwvt
洣	ioy
洤	iwgg
津	ivfh
洦	idjg
洧	ideg
洨	iuqy
洩	ijxt
洪	iawy
洫	itlg
洬	imgq
洭	iagg
洮	iiqn
洯	dhvi
洰	iang
洱	ibg
洲	iyth
洳	ivkg
洴	iuah
洵	iqjg
洶	iqqb
洷	igcf
洸	iiqn
洹	igjg
洺	iqkg
活	itdg
洼	iffg
洽	iwgk
派	irey
洿	idfn
浀	imag
流	iycq
浂	iudy
浃	iguw
浄	iqvh
浅	igt
浆	uqiu
浇	iatq
浈	ihmy
浉	ijgh
浊	ijy
测	imjh
浌	iwat
浍	iwfc
济	iyjh
浏	iyjh
浐	iutt
浑	iplh
浒	iytf
浓	ipey
浔	ivfy
浕	inyu
浖	iefy
浗	ifiy
浘	intn
浙	irrh
浚	icwt
浛	iwyk
浜	irgw
浝	idne
浞	ikhy
浟	iwht
浠	iqdh
浡	ifpb
浢	igku
浣	ipfq
浤	ipdc
浥	ikcn
浦	igey
浧	ikgg
浨	ipsy
浩	itfk
浪	iyve
浫	ipwf
浬	ijfg
浭	igjq
浮	iebg
浯	igkg
浰	itjh
浱	idfe
浲	itdh
浳	iaeg
浴	iwwk
浵	imye
浶	iprh
海	itxu
浸	ivpc
浹	idww
浺	inkh
浻	imwk
浼	iqkq
浽	ievg
浾	ifoy
浿	imy
涀	ihqn
涁	iset
涂	iwty
涃	ilsy
涄	imgn
涅	ijfg
涆	ijfh
涇	igva
消	iieg
涉	ihit
涊	ivyn
涋	ipdy
涌	iceh
涍	iftb
涎	ithp
涏	itfp
涐	itrt
涑	igki
涒	ivtk
涓	ikeg
涔	imwn
涕	iuxt
涖	iwug
涗	iwkq
涘	ictd
涙	iynd
涚	iukq
涛	idtf
涜	ifpq
涝	iapl
涞	igoy
涟	ilpy
涠	ilfh
涡	ikmw
涢	ikmy
涣	iqmd
涤	itsy
涥	iybh
润	iugg
涧	iujg
涨	ixty
涩	ivyh
涪	iukg
涫	ipnn
涬	ifuf
涭	iepc
涮	inmj
涯	idff
涰	iccc
涱	idey
液	iywy
涳	ipwa
涴	ipqb
涵	ibib
涶	itgf
涷	igji
涸	ildg
涹	itvg
涺	indg
涻	iwfk
涼	iyiy
涽	iqaj
涾	iijg
涿	ieyy
淀	ipgh
淁	iuvg
淂	ijgf
淃	iudb
淄	ivlg
淅	isrh
淆	iqde
淇	iadw
淈	inbm
淉	ijsy
淊	iqvg
淋	issy
淌	iimk
淍	imfk
淎	idwh
淏	ijgd
淐	ijjg
淑	ihic
淒	igvv
淓	iayn
淔	ifhg
淕	ifwf
淖	ihjh
淗	iqoy
淘	iqrm
淙	ipfi
淚	iynd
淛	irmj
淜	ieeg
淝	iecn
淞	iswc
淟	imaw
淠	ilgj
淡	iooy
淢	iakg
淣	ivqn
淤	iywu
淥	ixgi
淦	iqg
淧	ipnt
淨	ievh
淩	ifwt
淪	iwga
淫	ietf
淬	iywf
淭	iyns
淮	iwyg
淯	iyce
淰	iwyn
深	ipws
淲	iham
淳	iybg
淴	iqrn
淵	ijgg
淶	isww
混	ijxx
淸	igmg
淹	idjn
淺	iaat
添	igdn
淼	iiiu
淽	iahg
淾	qiu
淿	irmh
渀	idfa
渁	iiiy
渂	ijyy
渃	iadk
渄	idjd
清	igeg
渆	iuaj
渇	ijqx
済	iyjg
渉	ihit
渊	itoh
渋	ihiy
渌	iviy
渍	igmy
渎	ifnd
渏	idsk
渐	ilrh
渑	ikjn
渒	irtf
渓	iefw
渔	iqgg
渕	iudj
渖	ipjh
渗	icde
渘	icbs
渙	iqmd
渚	iftj
減	idgt
渜	idmd
渝	iwgj
渞	iuth
渟	iyps
渠	ians
渡	iyac
渢	imtj
渣	isjg
渤	ifpl
渥	ingf
渦	imnk
渧	iuph
渨	ilge
温	ijlg
渪	itky
渫	ians
測	imjh
渭	ileg
渮	iask
港	iawn
渰	iwga
渱	ijag
渲	ipgg
渳	ixbg
渴	ijqn
渵	ialg
渶	iamd
渷	iukq
游	iytb
渹	iqyg
渺	ihit
渻	iith
渼	iugd
渽	ifak
渾	iplh
渿	isfi
湀	iwgd
湁	irwk
湂	ikkn
湃	irdf
湄	inhg
湅	igli
湆	iujg
湇	iueg
湈	iafs
湉	intd
湊	idwd
湋	inhh
湌	iwye
湍	imdj
湎	idmd
湏	idmy
湐	isrg
湑	inhe
湒	ikbg
湓	iwvl
湔	iuej
湕	ivfp
湖	ideg
湗	ifff
湘	ishg
湙	iyod
湚	itxn
湛	iadn
湜	ijgh
湝	ixxr
湞	ihmy
湟	irgg
湠	imdo
湡	ijmy
湢	igkl
湣	inaj
湤	iytb
湥	ipwd
湦	ijtg
湧	icel
湨	ihdy
湩	itgf
湪	ixey
湫	itoy
湬	toiu
湭	iusg
湮	isfg
湯	ijgr
湰	itgg
湱	idhd
湲	iefc
湳	ifmf
湴	iuog
湵	iugy
湶	iriy
湷	idwj
湸	iypm
湹	idjf
湺	iwks
湻	iyjg
湼	ivag
湽	igvl
湾	iyox
湿	ijog
満	iamm
溁	iaps
溂	igkj
溃	ikhm
溄	imth
溅	imgt
溆	iwtc
溇	iovg
溈	iyto
溉	ivcq
溊	inhc
溋	iecl
溌	iwfq
溍	igoj
溎	isff
溏	iyvk
源	idri
溑	iimy
溒	ifke
溓	iuvo
溔	iugo
溕	ipge
準	iwyf
溗	itux
溘	ifcl
溙	idwi
溚	iawk
溛	ipwy
溜	iqyl
溝	ifjf
溞	icyj
溟	ipju
溠	iuda
溡	ijff
溢	iuwl
溣	iwwa
溤	icy
溥	igef
溦	imgt
溧	issy
溨	ifas
溩	iwno
溪	iexd
溫	ilwl
溬	iudc
溭	ilwt
溮	iwnh
溯	iube
溰	imgu
溱	idwt
溲	ivhc
溳	ikmy
溴	ithd
溵	irvc
溶	ipwk
溷	iley
溸	igxi
溹	ifpi
溺	ixuu
溻	ijng
溼	igxf
溽	idff
溾	irqc
溿	iluf
滀	iyxl
滁	ibwt
滂	iupy
滃	iwcn
滄	iwyk
滅	idgt
滆	igkh
滇	ifhw
滈	iymk
滉	ijiq
滊	irno
滋	iuxx
滌	iwhs
滍	ibhj
滎	oopi
滏	iwqu
滐	iqas
滑	imeg
滒	iskk
滓	ipuh
滔	ievg
滕	eudi
滖	iyke
滗	ittn
滘	ipwk
滙	iawy
滚	iuce
滛	ierm
滜	irdf
滝	iujn
滞	igkh
滟	idhc
滠	ibcc
满	iagw
滢	iapy
滣	idfk
滤	ihan
滥	ijtl
滦	iyos
滧	iuqt
滨	iprw
滩	icwy
滪	icbm
滫	iwhe
滬	iync
滭	ijaf
滮	ihae
滯	iaqh
滰	iujq
滱	ipfc
滲	icce
滳	iumk
滴	iumd
滵	ipnm
滶	igqt
滷	ihlo
滸	iytf
滹	ihah
滺	iwhn
滻	iutg
滼	issy
滽	iyvh
滾	iuke
滿	iamy
漀	fnmi
漁	iqoy
漂	isfi
漃	iphc
漄	imdf
漅	ivjs
漆	iswi
漇	ithh
漈	iwfi
漉	iynx
漊	ilvg
漋	ibtg
漌	iakg
漍	ilag
漎	itwh
漏	infy
漐	fufi
漑	irxq
漒	ixkj
漓	iybc
演	ipgw
漕	igmj
漖	iftt
漗	itln
漘	idfe
漙	igjf
漚	iakk
漛	iudi
漜	issf
漝	inrg
漞	iehq
漟	iipf
漠	iajd
漡	itjr
漢	iakw
漣	ilpy
漤	issv
漥	ipwf
漦	fiti
漧	ifjn
漨	itdp
漩	iyth
漪	iqtk
漫	ijlc
漬	igmy
漭	iada
漮	iyvi
漯	ilxi
漰	imee
漱	igkw
漲	ixde
漳	iujh
漴	impi
漵	iwtt
漶	ikkn
漷	iybb
漸	ilrh
漹	igho
漺	idqq
漻	inwe
漼	imwy
漽	inih
漾	iugi
漿	nhdi
潀	ilwu
潁	xidm
潂	imug
潃	itte
潄	igkt
潅	itdy
潆	iapi
潇	iavj
潈	itle
潉	imjx
潊	iwtc
潋	iwgt
潌	ipwf
潍	ixwy
潎	iumt
潏	icbk
潐	iwyo
潑	iwxc
潒	iqje
潓	igjn
潔	idhi
潕	irlo
潖	iggc
潗	iwys
潘	itol
潙	ieto
潚	ivfj
潛	iaqj
潜	ifwj
潝	iwgn
潞	ikhk
潟	ivqo
潠	innw
潡	iybt
潢	iamw
潣	iuyy
潤	iugg
潥	isoy
潦	idui
潧	iulj
潨	itli
潩	ilaw
潪	itdj
潫	iudi
潬	ikkf
潭	isjh
潮	ifje
潯	ivaf
潰	ikhm
潱	ifpu
潲	itie
潳	infj
潴	iqtj
潵	iaet
潶	ilfo
潷	itvh
潸	isse
潹	isss
潺	inbb
潻	itwi
潼	iujf
潽	iuoj
潾	ioqh
潿	ilnh
澀	ivyh
澁	ihhh
澂	imgt
澃	edmi
澄	iwgu
澅	ivfg
澆	iffq
澇	iool
澈	iyct
澉	inbt
澊	iusf
澋	ijyi
澌	iadr
澍	ifkf
澎	ifke
澏	ikkm
澐	iffc
澑	igal
澒	iadm
澓	ittt
澔	irtk
澕	iagf
澖	iusy
澗	iujg
澘	issj
澙	ivgo
澚	itmn
澛	iqgj
澜	iugi
澝	ipne
澞	ihad
澟	iylt
澠	ixg
澡	ikks
澢	iipl
澣	ifjf
澤	ilff
澥	iqeh
澦	icbm
澧	imau
澨	itaw
澩	wfqi
澪	ifwc
澫	iajy
澬	iuqm
澭	iyxy
澮	iwgj
澯	ihqo
澰	iwgw
澱	inac
澲	iogw
澳	itmd
澴	ilge
澵	iusr
澶	iylg
澷	ijly
澸	idgn
澹	iqdy
澺	iujn
澻	iuep
澼	inku
澽	ihae
澾	ifup
澿	issi
激	iryt
濁	ilqj
濂	iyuo
濃	imae
濄	imnp
濅	ipvc
濆	ifam
濇	ifwk
濈	ikbt
濉	ihwy
濊	ihdt
濋	issh
濌	tgjj
濍	iaqn
濎	ihnn
濏	iggt
濐	ijfj
濑	igkm
濒	ihim
濓	iuto
濔	igwq
濕	ijxo
濖	ilfj
濗	iajh
濘	ipns
濙	iooo
濚	ioos
濛	iape
濜	ivhl
濝	iadi
濞	ithj
濟	iyjg
濠	iype
濡	ifdj
濢	inyf
濣	ifjf
濤	ifnf
濥	iqpw
濦	iean
濧	iogf
濨	iuxn
濩	iawc
濪	igec
濫	iahl
濬	ihph
濭	iafl
濮	iwoy
濯	inwy
濰	ixwy
濱	ipgm
濲	ifpc
濳	itfj
濴	iooi
濵	ipnm
濶	iutd
濷	iiay
濸	iawk
濹	ijff
濺	imaa
濻	ibkm
濼	ixrs
濽	ifwm
濾	ihan
濿	iday
瀀	idet
瀁	iude
瀂	iqoj
瀃	imjr
瀄	itvb
瀅	iooy
瀆	iflm
瀇	iyaw
瀈	inpl
瀉	ipvo
瀊	itel
瀋	iptl
瀌	iyno
瀍	iyjf
瀎	ialt
瀏	iqyj
瀐	ifag
瀑	ijai
瀒	iswk
瀓	itmt
瀔	ifpc
瀕	ihim
瀖	ifwy
瀗	ipdn
瀘	ihal
瀙	iusq
瀚	ifjn
瀛	iyny
瀜	igkj
瀝	idth
瀞	igeh
瀟	iavj
瀠	iooi
瀡	ibdp
瀢	ikhp
瀣	ihqg
瀤	iyle
瀥	inyk
瀦	iefj
瀧	iued
瀨	igkm
瀩	itmm
瀪	txgi
瀫	ifpc
瀬	igkm
瀭	ilwj
瀮	ifss
瀯	iook
瀰	ixgq
瀱	ildj
瀲	iwgt
瀳	iayo
瀴	immv
瀵	iolw
瀶	iahk
瀷	inlw
瀸	iwwg
瀹	iwga
瀺	iqky
瀻	ifaw
瀼	iyke
瀽	ipfh
瀾	iugi
瀿	itxi
灀	ifsh
灁	iuri
灂	ielf
灃	idhu
灄	ibbb
灅	illf
灆	iaal
灇	iogc
灈	ihhy
灉	ivky
灊	iaqh
灋	iync
灌	iaky
灍	iuuw
灎	imal
灏	ijym
灐	iooq
灑	igmx
灒	itfm
灓	xyxi
灔	imac
灕	iyby
灖	iysd
灗	ijyg
灘	iaky
灙	iipo
灚	iwfq
灛	iukf
灜	iyny
灝	ijym
灞	ifae
灟	inij
灠	iahq
灡	iaui
灢	igke
灣	ixyx
灤	ixys
灥	riri
灦	ijxm
灧	idhc
灨	iujm
灩	idhl
灪	isre
火	oooo
灬	oyyy
灭	goi
灮	oqb
灯	osh
灰	dou
灱	ovn
灲	ojh
灳	qoi
灴	oag
灵	vou
灶	ofg
灷	oaj
灸	qyou
灹	otan
灺	obn
灻	fou
灼	oqyy
災	vou
灾	pou
灿	omh
炀	onrt
炁	aqou
炂	owcy
炃	wvou
炄	onfg
炅	jou
炆	oyy
炇	oty
炈	omcy
炉	oynt
炊	oqwy
炋	ogiy
炌	owjh
炍	orcy
炎	oou
炏	ooy
炐	odhh
炑	osy
炒	oitt
炓	oufh
炔	onwy
炕	oymn
炖	ogbn
炗	aou
炘	orh
炙	qou
炚	joy
炛	owxb
炜	ofnh
炝	owbn
炞	oyhy
炟	ojgg
炠	olh
炡	oghg
炢	osyy
炣	oskg
炤	ovkg
炥	oxjh
炦	odcy
炧	otbn
炨	opxn
炩	owyc
炪	obmh
炫	oyxy
炬	oang
炭	mdou
炮	oqnn
炯	omkg
炰	qnou
炱	ckou
炲	ockg
炳	ogmw
炴	omdy
炵	otuy
炶	ohkg
炷	oygg
炸	othf
点	hkou
為	ytno
炻	odg
炼	oanw
炽	okwy
炾	okqn
炿	otmy
烀	otuh
烁	oqiy
烂	oufg
烃	ocag
烄	ouqy
烅	otlg
烆	otfh
烇	owgg
烈	gqjo
烉	qmwo
烊	oudh
烋	wsou
烌	owsy
烍	otfq
烎	gaou
烏	wngo
烐	otey
烑	oiqn
烒	eeee
烓	offg
烔	omgk
烕	dgot
烖	faoi
烗	oynw
烘	oawy
烙	otkg
烚	owgk
烛	ojy
烜	ogjg
烝	bigo
烞	oshy
烟	oldy
烠	odeg
烡	oawu
烢	opta
烣	odoy
烤	oftn
烥	oahh
烦	odmy
烧	oatq
烨	owxf
烩	owfc
烪	oudy
烫	inro
烬	onyu
热	rvyo
烮	gqjo
烯	oqdh
烰	oebg
烱	omwk
烲	rrou
烳	ogey
烴	ogva
烵	oaqy
烶	otfp
烷	opfq
烸	otxu
烹	ybou
烺	oyve
烻	othp
烼	oey
烽	otdh
烾	ooff
烿	omye
焀	owwk
焁	kqwo
焂	whto
焃	ofoy
焄	vtko
焅	otfk
焆	okeg
焇	oieg
焈	ynno
焉	ghgo
焊	ojfh
焋	nhdo
焌	ocwt
焍	ouxt
焎	rrou
焏	bkco
焐	ogkg
焑	olsy
焒	okkg
焓	owyk
焔	oqhj
焕	oqmd
焖	ouny
焗	onnk
焘	dtfo
焙	oukg
焚	ssou
焛	uoi
焜	ojxx
焝	oqaj
焞	oybg
焟	oajg
焠	oywf
無	rlgo
焢	opwa
焣	bcou
焤	ywfo
焥	opqb
焦	wyou
焧	owcn
焨	ojeg
焩	oeeg
焪	opwx
焫	oamw
焬	ojqr
焭	oopm
焮	orqw
焯	ohjh
焰	oqvg
焱	ooou
焲	oywy
焳	owyg
焴	oyce
焵	omum
然	qdou
焷	ortf
焸	jjou
焹	omun
焺	ojta
焻	ojjg
焼	ofaq
焽	jeou
焾	owyn
焿	oyvw
煀	onbm
煁	oadn
煂	oafh
煃	odff
煄	otgf
煅	owdc
煆	onhc
煇	oplh
煈	omtj
煉	ogli
煊	opgg
煋	ojtg
煌	orgg
煍	otoy
煎	uejo
煏	ogkl
煐	oamd
煑	ftjo
煒	onhh
煓	omdj
煔	oohk
煕	ahho
煖	oefc
煗	odmd
煘	odgt
煙	osfg
煚	jano
煛	hhou
煜	ojug
煝	onhg
煞	qvto
煟	oleg
煠	oans
煡	ovfp
煢	oopf
煣	ocbs
煤	oafs
煥	oqmd
煦	jqko
照	jvko
煨	olge
煩	odmy
煪	ousg
煫	ouey
煬	ojgr
煭	vgqo
煮	ftjo
煯	oxxr
煰	okkk
煱	omnk
煲	wkso
煳	odeg
煴	ojlg
煵	ofmf
煶	ojgh
煷	oypm
煸	oyna
煹	ofjf
煺	ovep
煻	oyvk
煼	oqbt
煽	oynn
煾	oldn
煿	ogef
熀	ojiq
熁	olle
熂	oooo
熃	cbto
熄	othn
熅	olwl
熆	ofcl
熇	oymk
熈	taho
熉	okmy
熊	cexo
熋	cexo
熌	ouwy
熍	opkk
熎	oerm
熏	tglo
熐	opju
熑	ouvo
熒	oopo
熓	owno
熔	opwk
熕	oamy
熖	oevg
熗	owyk
熘	oqyl
熙	ahko
熚	ojaf
熛	osfi
熜	otln
熝	oynx
熞	oahf
熟	ybvo
熠	onrg
熡	olvg
熢	otdp
熣	omwy
熤	onug
熥	ocep
熦	oiwy
熧	twwo
熨	nfio
熩	oync
熪	otqq
熫	oyao
熬	gqto
熭	dhdo
熮	onwe
熯	oakw
熰	oakk
熱	fwfo
熲	xodm
熳	ojlc
熴	omjx
熵	oumk
熶	ojbc
熷	oulj
熸	oaqj
熹	fkuo
熺	ofkk
熻	owgn
熼	olaw
熽	ovfj
熾	ouaj
熿	oamw
燀	okkf
燁	oagf
燂	osjh
燃	oqdo
燄	qvoo
燅	fwfo
燆	otdk
燇	ousf
燈	owgu
燉	oybt
燊	ooos
燋	owyo
燌	ofam
燍	oadr
燎	odui
燏	ocbk
燐	ooqh
燑	oujf
燒	offq
燓	sqqo
燔	otol
燕	auko
燖	ovaf
燗	oueg
燘	ouyy
燙	ijgo
燚	oooo
燛	nhao
燜	ouny
燝	ojyi
燞	wyqo
營	oopk
燠	otmd
燡	olff
燢	wfqo
燣	oylt
燤	oajy
燥	okks
燦	ohqo
燧	ouep
燨	ougt
燩	oryt
燪	oaqn
燫	oyuo
燬	ovac
燭	olqj
燮	oyoc
燯	ofwc
燰	oept
燱	oujn
燲	ollm
燳	ojvo
燴	owgj
燵	ofup
燶	omae
燷	oyli
燸	ofdj
燹	eeou
燺	oyms
燻	otgo
燼	ovhl
燽	ofnf
燾	fnao
燿	onwy
爀	ofoo
爁	oahl
爂	wfmo
爃	ooos
爄	oday
爅	olff
爆	ojai
爇	afwo
爈	ohan
爉	ovln
爊	oyno
爋	otgo
爌	oyaw
爍	oxrs
爎	opdi
爏	odth
爐	ohal
爑	oawo
爒	qodi
爓	ouqv
爔	ougt
爕	oyoo
爖	oued
爗	ojaf
爘	ohqe
爙	oyke
爚	owga
爛	ougi
爜	oogc
爝	oelf
爞	ojjj
爟	oaky
爠	ohhy
爡	oajj
爢	ysso
爣	oipo
爤	oaui
爥	onij
爦	oahq
爧	ofkw
爨	wfmo
爩	osre
爪	rhyi
爫	etyt
爬	rhyc
爭	evhj
爮	rhyn
爯	emff
爰	eftc
爱	epdc
爲	etno
爳	etnb
爴	laky
爵	elvf
父	wqu
爷	wqbj
爸	wqcb
爹	wqqq
爺	wqbb
爻	qqu
爼	qqeg
爽	dqqq
爾	gwmq
爿	nhde
牀	nhds
牁	nhdk
牂	nhdd
牃	nhds
牄	nhdk
牅	nhdh
牆	nhdk
片	thgn
版	thgc
牉	thgf
牊	thgk
牋	thga
牌	thgf
牍	thgd
牎	thgn
牏	thgj
牐	thgv
牑	thga
牒	thgs
牓	thgy
牔	thgf
牕	thgn
牖	thgy
牗	thgh
牘	thgm
牙	ahte
牚	ipkt
牛	rhk
牜	trd
牝	trxn
牞	trln
牟	crhj
牠	trbn
牡	trfg
牢	prhj
牣	trvy
牤	tryn
牥	tryn
牦	trtn
牧	trty
牨	trym
物	trqr
牪	trrh
牫	trat
牬	trtt
牭	trlg
牮	warh
牯	trdg
牰	trmg
牱	trsk
牲	trtg
牳	trxu
牴	trqy
牵	dprh
牶	udrh
牷	trwg
牸	trpb
特	trff
牺	trsg
牻	trde
牼	trga
牽	yxph
牾	trgk
牿	trtk
犀	nirh
犁	tjrh
犂	tqth
犃	truk
犄	trdk
犅	trmm
犆	trfh
犇	rhth
犈	trub
犉	tryb
犊	trfd
犋	trhw
犌	trnc
犍	trvp
犎	fffh
犏	trya
犐	trtf
犑	trhd
犒	tryk
犓	trqt
犔	trro
犕	trae
犖	ooph
犗	trpk
犘	yssh
犙	trce
犚	nfih
犛	fith
犜	tryt
犝	truf
犞	trtk
犟	xkjh
犠	trut
犡	trdy
犢	trfm
犣	trvn
犤	trlx
犥	tryo
犦	trji
犧	trut
犨	wywh
犩	tvrh
犪	trut
犫	wyyh
犬	dgty
犭	qte
犮	dcu
犯	qtbn
犰	qtvn
犱	qtvy
犲	qtft
犳	qtqy
犴	qtfh
犵	qttn
状	udy
犷	qtyt
犸	qtcg
犹	qtdn
犺	qtym
犻	qtgh
犼	qtbn
犽	qtat
犾	qtdy
犿	qtyh
狀	nhdd
狁	qtcq
狂	qtgg
狃	qtnf
狄	qtoy
狅	qttf
狆	qtkh
狇	qtsy
狈	qtmy
狉	qtgg
狊	hdu
狋	qtfi
狌	qttg
狍	qtqn
狎	qtlh
狏	qttb
狐	qtry
狑	qtwc
狒	qtxj
狓	qthc
狔	qtnx
狕	qtxl
狖	qtpw
狗	qtqk
狘	qtat
狙	qteg
狚	qtjg
狛	qtrg
狜	qtdg
狝	qtqi
狞	qtps
狟	qtgg
狠	qtve
狡	qtuq
狢	qttk
狣	qtiq
狤	qtfk
狥	qtqj
狦	qtmj
狧	qttd
狨	qtad
狩	qtpf
狪	qtmk
狫	qtfx
独	qtjy
狭	qtgw
狮	qtjh
狯	qtwc
狰	qtqh
狱	qtyd
狲	qtbi
狳	qtwt
狴	qtxf
狵	qtde
狶	qtqh
狷	qtke
狸	qtjf
狹	qtdw
狺	qtyg
狻	qtct
狼	qtye
狽	qtmy
狾	qtrr
狿	qttp
猀	qtit
猁	qttj
猂	qtjf
猃	qtwi
猄	qtyi
猅	qtdd
猆	djdd
猇	qthm
猈	qtrf
猉	qtaw
猊	qtvq
猋	dddu
猌	swwd
猍	qtsw
猎	qtaj
猏	qtye
猐	qtun
猑	qtjx
猒	jedy
猓	qtjs
猔	qtpi
猕	qtxi
猖	qtjj
猗	qtdk
猘	qtrj
猙	qteh
猚	qtwy
猛	qtbl
猜	qtge
猝	qtyf
猞	qtwk
猟	qtih
猠	qtmw
猡	qtlq
猢	qtde
猣	qtqt
猤	qtwd
猥	qtle
猦	qtmj
猧	qtmk
猨	qtec
猩	qtjg
猪	qtfj
猫	qtal
猬	qtle
猭	qtxe
献	fmud
猯	qtmj
猰	qtdd
猱	qtcs
猲	qtjn
猳	qtnc
猴	qtwd
猵	qtya
猶	qtug
猷	usgd
猸	qtnh
猹	qtsg
猺	qtem
猻	qtbi
猼	qtgf
猽	qtpu
猾	qtme
猿	qtfe
獀	qtvc
獁	qtcy
獂	qtdi
獃	mgkd
獄	qtyd
獅	qtwh
獆	qtrf
獇	qtuc
獈	qtul
獉	qtdt
獊	qtwk
獋	qttf
獌	qtjc
獍	qtuq
獎	nhdd
獏	qtad
獐	qtuj
獑	qtlr
獒	gqtd
獓	qtgt
獔	qtrf
獕	qtmy
獖	qtfm
獗	qtdw
獘	umid
獙	qtut
獚	qtaw
獛	qtoy
獜	qtoh
獝	qtck
獞	qtuf
獟	qtfq
獠	qtdi
獡	qtvo
獢	qttk
獣	ilgd
獤	qtyt
獥	qtrt
獦	qtan
獧	qtle
獨	qtlj
獩	qtht
獪	qtwj
獫	qtww
獬	qtqh
獭	qtgm
獮	qtgq
獯	qtto
獰	qtps
獱	qtpm
獲	qtac
獳	qtfj
獴	qtae
獵	qtvn
獶	qtdt
獷	qtyw
獸	kkld
獹	qthl
獺	qtgm
獻	hagd
獼	qtxq
獽	qtye
獾	qtay
獿	qtgt
玀	qtly
玁	qtkt
玂	qtar
玃	qthc
玄	yxu
玅	yxit
玆	yxyx
率	yxif
玈	yxte
玉	gyi
玊	gyi
王	gggg
玌	gnn
玍	tff
玎	gsh
玏	gln
玐	gwy
玑	gmn
玒	gag
玓	gqyy
玔	gkh
玕	gfh
玖	gqyy
玗	ggfh
玘	gnn
玙	ggng
玚	gnrt
玛	gcg
玜	gwcy
玝	gtfh
玞	gfwy
玟	gyy
玠	gwjh
玡	gaht
玢	gwvn
玣	gyhy
玤	gdhh
玥	geg
玦	gnwy
玧	gcqn
玨	ggg
玩	gfqn
玪	gwyn
玫	gty
玬	gmyg
玭	gxxn
玮	gfnh
环	ggiy
现	gmqn
玱	gwbn
玲	gwyc
玳	gway
玴	gann
玵	gafg
玶	gguh
玷	ghkg
玸	gqnn
玹	gyxy
玺	qigy
玻	ghcy
玼	ghxn
玽	gqkg
玾	glh
玿	gvkg
珀	grg
珁	ggnn
珂	gskg
珃	gmfg
珄	gtgg
珅	gjhh
珆	gckg
珇	gegg
珈	glkg
珉	gnan
珊	gmmg
珋	gqtb
珌	gntt
珍	gwet
珎	gqiy
珏	ggyy
珐	gfcy
珑	gdxn
珒	gvfh
珓	guqy
珔	gdhb
珕	glll
珖	giqn
珗	gtfq
珘	gtey
珙	gawy
珚	gldy
珛	gdeg
珜	gudh
珝	gng
珞	gtkg
珟	gmgq
珠	griy
珡	ggwu
珢	gvey
珣	gqjg
珤	grmh
珥	gbg
珦	gtmk
珧	giqn
珨	gwgk
珩	gtfh
珪	gffg
珫	gycq
珬	gdgt
班	gytg
珮	gmgh
珯	gftx
珰	givg
珱	givg
珲	gplh
珳	gyet
珴	gtrt
珵	gkgg
珶	guxt
珷	ggah
珸	ggkg
珹	gdnt
珺	gvtk
珻	gtxu
珼	gmy
珽	gtfp
現	ghqn
珿	gkhy
琀	gwyk
琁	gtnh
琂	gyg
球	gfiy
琄	gkeg
琅	gyve
理	gjfg
琇	gten
琈	gebg
琉	gycq
琊	gahb
琋	gqdh
琌	gmwn
琍	gtjh
琎	gfjp
琏	glpy
琐	gimy
琑	gieg
琒	gtdh
琓	gpfq
琔	gpgh
琕	grtf
琖	gaat
琗	gywf
琘	gqaj
琙	gakg
琚	gndg
琛	gpws
琜	gsww
琝	gjyy
琞	jegy
琟	gwyg
琠	gmaw
琡	ghic
琢	geyy
琣	gukg
琤	gqvh
琥	gham
琦	gdsk
琧	gfgy
琨	gjxx
琩	gjjg
琪	gadw
琫	gdwh
琬	gpqb
琭	gviy
琮	gpfi
琯	gpnn
琰	gooy
琱	gmfk
琲	gdjd
琳	gssy
琴	ggwn
琵	ggxx
琶	ggcb
琷	gudn
琸	ghjh
琹	ggsu
琺	gifc
琻	gqg
琼	gyiy
琽	gftj
琾	glwj
琿	gplh
瑀	gtky
瑁	gjhg
瑂	gnhg
瑃	gdwj
瑄	gpgg
瑅	gjgh
瑆	gjtg
瑇	ggxu
瑈	gcbs
瑉	gnaj
瑊	gdgt
瑋	gnhh
瑌	gdmd
瑍	gqmd
瑎	gxxr
瑏	gpwt
瑐	guej
瑑	gxey
瑒	gjgr
瑓	ggli
瑔	griy
瑕	gnhc
瑖	gwdc
瑗	gefc
瑘	gbbh
瑙	gvtq
瑚	gdeg
瑛	gamd
瑜	gwgj
瑝	grgg
瑞	gmdj
瑟	ggnt
瑠	gqyl
瑡	gwnh
瑢	gpwk
瑣	gimy
瑤	gqrm
瑥	gjlg
瑦	gwno
瑧	gdwt
瑨	ggoj
瑩	oopy
瑪	gcy
瑫	gevg
瑬	iycy
瑭	gyvk
瑮	gssy
瑯	gyvb
瑰	grqc
瑱	gfhw
瑲	gwyk
瑳	guda
瑴	fpgc
瑵	gcyj
瑶	germ
瑷	gepc
瑸	gprw
瑹	gawt
瑺	giph
瑻	gxfm
瑼	ggjf
瑽	gtwh
瑾	gakg
瑿	atdy
璀	gmwy
璁	gtln
璂	gadf
璃	gybc
璄	gujq
璅	gvjs
璆	gnwe
璇	gyth
璈	ggqt
璉	glpy
璊	gamy
璋	gujh
璌	gpgw
璍	gagf
璎	gmmv
璏	gxgx
璐	gkhk
璑	grlo
璒	gwgu
璓	gate
璔	gulj
璕	gvaf
璖	gias
璗	ijgy
璘	goqh
璙	gdui
璚	gcbk
璛	gvfj
璜	gamw
璝	gkhm
璞	gogy
璟	gjyi
璠	gtol
璡	gwyp
璢	ggal
璣	gxxt
璤	ggjn
璥	gaqt
璦	gept
璧	nkuy
璨	ghqo
璩	ghae
璪	gkks
璫	gipl
璬	gryt
璭	gplp
璮	gylg
璯	gwgj
環	glge
璱	gggt
璲	guep
璳	grim
璴	gssh
璵	gwfw
璶	gvhl
璷	gget
璸	gpgm
璹	gfnf
璺	wfmy
璻	gnyf
璼	gahl
璽	gwmy
璾	gyjg
璿	ghph
瓀	gfdj
瓁	gawc
瓂	gafl
瓃	glll
瓄	gflm
瓅	gxrs
瓆	grrm
瓇	gdet
瓈	gtqi
瓉	gfwm
瓊	gqmt
瓋	gump
瓌	gyle
瓍	gbdp
瓎	ggkm
瓏	gued
瓐	ghal
瓑	gdth
瓒	gtfm
瓓	gugi
瓔	gmmv
瓕	xgwy
瓖	gyke
瓗	gmwk
瓘	gaky
瓙	gfno
瓚	gtfm
瓛	ghad
瓜	rcyi
瓝	rcyy
瓞	rcyw
瓟	rcyn
瓠	dfny
瓡	fufy
瓢	sfiy
瓣	urcu
瓤	ykky
瓥	rcyj
瓦	gnyn
瓧	gnyf
瓨	agnn
瓩	gnyf
瓪	gnyc
瓫	wvgn
瓬	ygnn
瓭	pqgn
瓮	wcgn
瓯	aqgn
瓰	gnyv
瓱	gnyn
瓲	gnyn
瓳	dgnn
瓴	wycn
瓵	ckgn
瓶	uagn
瓷	uqwn
瓸	gnyj
瓹	kegn
瓺	dgnn
瓻	qdmn
瓼	gnyf
瓽	ipkn
瓾	tvgn
瓿	ukgn
甀	tgan
甁	tftn
甂	ynmn
甃	togn
甄	sfgn
甅	gnyf
甆	uxxn
甇	oopn
甈	thsn
甉	uvon
甊	lvgn
甋	umdn
甌	akkn
甍	alpn
甎	gjhn
甏	fkun
甐	oqan
甑	uljn
甒	rlgn
甓	nkun
甔	qdwn
甕	yxtn
甖	mmgn
甗	hagn
甘	afd
甙	aafd
甚	adwn
甛	aftd
甜	tdaf
甝	hamf
甞	ipkf
生	tgd
甠	jtgg
甡	tgtg
產	ydtg
産	uttg
甤	etgd
甥	tgll
甦	gjqg
甧	tgte
用	etnh
甩	env
甪	tek
甫	gehy
甬	cej
甭	giej
甮	qrej
甯	pnej
田	llll
由	mhng
甲	lhnh
申	jhk
甴	jhk
电	jnv
甶	tld
男	llb
甸	qld
甹	mgnb
町	lsh
画	glbj
甼	lsj
甽	lkh
甾	vlf
甿	lynn
畀	lgjj
畁	mgjj
畂	lqyy
畃	jhqy
畄	ilf
畅	jhnr
畆	ylcy
畇	lqug
畈	lrcy
畉	lfwy
畊	lfjh
畋	lty
界	lwjj
畍	lwjh
畎	ldy
畏	lgeu
畐	gklf
畑	olg
畒	ylwy
畓	ilf
畔	lufh
畕	llf
畖	lrcy
畗	ylf
畘	lmfg
留	qyvl
畚	cdlf
畛	lwet
畜	yxlf
畝	ylqy
畞	flqy
畟	lwtu
畠	rlf
畡	lynw
畢	jafk
畣	wgkl
畤	lffy
略	ltkg
畦	lffg
畧	ltkf
畨	olf
畩	lyey
番	tolf
畫	vflg
畬	wtlf
畭	lwty
畮	ltxu
畯	lcwt
異	lawu
畱	gajl
畲	wfil
畳	lpeg
畴	ldtf
畵	vflb
當	ipkl
畷	lccc
畸	ldsk
畹	lpqb
畺	glgg
畻	ludf
畼	ljgr
畽	ltgf
畾	lllf
畿	xxal
疀	vlgh
疁	lnwe
疂	lipg
疃	lujf
疄	loqh
疅	lglg
疆	xfgg
疇	lfnf
疈	gkll
疉	lllg
疊	lllg
疋	nhi
疌	gvhi
疍	nhjg
疎	nhgi
疏	nhyq
疐	fplh
疑	xtdh
疒	uygg
疓	uev
疔	usk
疕	uxv
疖	ubk
疗	ubk
疘	uad
疙	utnv
疚	uqyi
疛	ufi
疜	ughi
疝	umk
疞	ufnv
疟	uagd
疠	udnv
疡	unre
疢	uoi
疣	udnv
疤	ucv
疥	uwjk
疦	unwi
疧	uqav
疨	uaht
疩	uvfk
疪	uxxv
疫	umci
疬	udlv
疭	uwwi
疮	uwbv
疯	umqi
疰	uygd
疱	uqnv
疲	uhci
疳	uafd
疴	uskd
疵	uhxv
疶	uanv
疷	uqay
疸	ujgd
疹	uwee
疺	utpi
疻	ukwi
疼	utui
疽	uegd
疾	utdi
疿	uxjk
痀	uqkd
痁	uhkd
痂	ulkd
痃	uyxi
痄	uthf
病	ugmw
痆	unxv
症	ughd
痈	uek
痉	ucad
痊	uwgd
痋	uji
痌	umgk
痍	ugxw
痎	uynw
痏	uded
痐	ulkd
痑	uqqi
痒	uudk
痓	ugcf
痔	uffi
痕	uvei
痖	ugog
痗	utxu
痘	ugku
痙	ugva
痚	uftb
痛	ucek
痜	utmv
痝	udne
痞	ugik
痟	uied
痠	ucwt
痡	ugey
痢	utjk
痣	ufni
痤	uwwf
痥	uukq
痦	ugkd
痧	uiit
痨	uapl
痩	ujhc
痪	uqmd
痫	uusi
痬	ujqr
痭	ueed
痮	udei
痯	upnn
痰	uooi
痱	udjd
痲	usfq
痳	ussi
痴	utdk
痵	utbd
痶	umaw
痷	udjn
痸	urmj
痹	ulgj
痺	urtf
痻	uqaj
痼	uldd
痽	uwyd
痾	ubsk
痿	utvd
瘀	uywu
瘁	uywf
瘂	ugfg
瘃	ueyi
瘄	uajd
瘅	uujf
瘆	ucde
瘇	utgf
瘈	udhd
瘉	uwgj
瘊	uwnd
瘋	umtj
瘌	ugkj
瘍	ujgr
瘎	uadn
瘏	uftj
瘐	uvwi
瘑	umnk
瘒	uplk
瘓	uqmd
瘔	uadd
瘕	unhc
瘖	uujd
瘗	uguf
瘘	uovd
瘙	ucyj
瘚	uubw
瘛	udhn
瘜	uthn
瘝	ulii
瘞	udwf
瘟	ujld
瘠	uiwe
瘡	uwyk
瘢	utec
瘣	urqc
瘤	uqyl
瘥	uuda
瘦	uvhc
瘧	uhag
瘨	ufhw
瘩	uawk
瘪	uthx
瘫	ucwy
瘬	uxde
瘭	usfi
瘮	ucce
瘯	uytd
瘰	ulxi
瘱	udwn
瘲	utwh
瘳	unwe
瘴	uujk
瘵	uwfi
瘶	ugkw
瘷	ugkt
瘸	ulkw
瘹	uqqy
瘺	unfi
瘻	ulvd
瘼	uajd
瘽	uakg
瘾	ubqn
瘿	ummv
癀	uamw
癁	uttt
療	udui
癃	ubtg
癄	uwyo
癅	ugal
癆	uool
癇	uued
癈	uwxc
癉	ukkf
癊	ubwc
癋	ugfn
癌	ukkm
癍	ugyg
癎	uujd
癏	ulge
癐	uwgj
癑	umae
癒	uwgn
癓	utmt
癔	uujn
癕	uyxy
癖	unku
癗	ufld
癘	uajy
癙	uvnn
癚	uqdy
癛	uylt
癜	unac
癝	uyli
癞	ugkm
癟	utha
癠	uyjd
癡	uxth
癢	uude
癣	uqgd
癤	utvb
癥	utmt
癦	ulff
癧	udth
癨	ufwy
癩	ugkm
癪	utgm
癫	ufhm
癬	uqod
癭	ummv
癮	uben
癯	uhhy
癰	uvky
癱	uaky
癲	ufhm
癳	ulli
癴	uxyr
癵	uxyw
癶	wnyt
癷	wfj
癸	wgdu
癹	wmcu
発	wfqb
登	wgku
發	wxmc
白	rrrr
百	djf
癿	rnn
皀	rxb
皁	rfj
皂	rab
皃	rqb
的	rqyy
皅	rcn
皆	xxrf
皇	rgf
皈	rrcy
皉	rhxn
皊	rwyc
皋	rdfj
皌	rgsy
皍	rxbj
皎	ruqy
皏	ruah
皐	rifj
皑	rmnn
皒	rtrt
皓	rtfk
皔	rjfh
皕	djdj
皖	rpfq
皗	rmfk
皘	rgeg
皙	srrf
皚	rmgu
皛	rrrf
皜	rymk
皝	rgiq
皞	rrdf
皟	rgmy
皠	rmwy
皡	rrif
皢	rffq
皣	ragf
皤	rtol
皥	rthf
皦	rryt
皧	rept
皨	rrrf
皩	rgjq
皪	rxrs
皫	ryno
皬	rfwy
皭	relf
皮	hci
皯	hcfh
皰	hcqn
皱	qvhc
皲	plhc
皳	fiyc
皴	cwtc
皵	ajhc
皶	sjgc
皷	fkuc
皸	plhc
皹	hcpl
皺	qbtc
皻	haec
皼	fpgc
皽	ylkc
皾	flmc
皿	lhng
盀	hlf
盁	pyfg
盂	gflf
盃	gilf
盄	xhlf
盅	khlf
盆	wvlf
盇	dylf
盈	eclf
盉	tlf
益	uwlf
盋	dclf
盌	qblf
盍	fclf
盎	mdlf
盏	glf
盐	fhlf
监	jtyl
盒	wgkl
盓	igfl
盔	dolf
盕	imyl
盖	uglf
盗	uqwl
盘	telf
盙	gehl
盚	fiyl
盛	dnnl
盜	iqwl
盝	vilf
盞	aalf
盟	jelf
盠	xelf
盡	vhgl
盢	ldlf
監	ahnl
盤	teml
盥	wfil
盦	wynl
盧	hall
盨	edml
盩	fufl
盪	ijgl
盫	wgkl
盬	ahnl
盭	xful
目	hhhh
盯	hsh
盰	hfh
盱	hgfh
盲	ynhf
盳	hynn
直	fhf
盵	htnn
盶	hfqn
盷	hqug
相	shg
盹	hgbn
盺	hrh
盻	hwgn
盼	hwvn
盽	hdhh
盾	rfhd
盿	hyy
眀	heg
省	ithf
眂	hqan
眃	hfcy
眄	hghn
眅	hrcy
眆	hyn
眇	hitt
眈	hpqn
眉	nhd
眊	htfn
看	rhf
県	hniu
眍	haqy
眎	hfiy
眏	hmdy
眐	hghg
眑	hxln
眒	hjhh
眓	hant
眔	liu
眕	hwet
眖	hkqn
眗	hqkg
眘	duhf
眙	hckg
眚	tghf
眛	hfiy
眜	hgsy
眝	hpsh
眞	xhnw
真	fhwu
眠	hnan
眡	hqay
眢	qbhf
眣	hrwy
眤	hnxn
眥	hxhf
眦	hhxn
眧	hvkg
眨	htpy
眩	hyxy
眪	hgmw
眫	hufh
眬	hdxn
眭	hffg
眮	hmgk
眯	hoy
眰	hgcf
眱	hgxw
眲	hbg
眳	hqkg
眴	hqjg
眵	hqqy
眶	hagg
眷	udhf
眸	hcrh
眹	hudy
眺	hiqn
眻	hudh
眼	hvey
眽	hrey
眾	lwwu
眿	hyni
着	udhf
睁	hqvh
睂	wwhh
睃	hcwt
睄	hieg
睅	hjfh
睆	hpfq
睇	huxt
睈	hkgg
睉	hwwf
睊	hkeg
睋	htrt
睌	hqkq
睍	hhqn
睎	hqdh
睏	hlsy
睐	hgoy
睑	hwgi
睒	hooy
睓	hmaw
睔	hwga
睕	hpqb
睖	hfwt
睗	hjqr
睘	lgke
睙	hynd
睚	hdff
睛	hgeg
睜	hevh
睝	tqth
睞	hsww
睟	hywf
睠	hudb
睡	htgf
睢	hwyg
督	hich
睤	hlgj
睥	hrtf
睦	hfwf
睧	hqaj
睨	hvqn
睩	hviy
睪	lfuf
睫	hgvh
睬	hesy
睭	hmfk
睮	hwgj
睯	nath
睰	hadk
睱	hnhc
睲	hjtg
睳	hdff
睴	hplh
睵	hfak
睶	hdwj
睷	hvfp
睸	hnhg
睹	hftj
睺	hwnd
睻	hpgg
睼	hjgh
睽	hwgd
睾	tlff
睿	hpgh
瞀	cbth
瞁	hhdy
瞂	rfhc
瞃	hrfh
瞄	halg
瞅	htoy
瞆	hkhm
瞇	hopy
瞈	hwcn
瞉	fpgc
瞊	hyvk
瞋	hfhw
瞌	hfcl
瞍	hvhc
瞎	hpdk
瞏	lfke
瞐	hhhf
瞑	hpju
瞒	hagw
瞓	hykh
瞔	hgmy
瞕	hujh
瞖	atdh
瞗	hwvo
瞘	hakk
瞙	hajd
瞚	hpgw
瞛	htwh
瞜	hlvg
瞝	hybc
瞞	hamy
瞟	hsfi
瞠	hipf
瞡	hfwq
瞢	alph
瞣	hkkn
瞤	hugg
瞥	umih
瞦	hfkk
瞧	hwyo
瞨	hogy
瞩	hnty
瞪	hwgu
瞫	hsjh
瞬	heph
瞭	hdui
瞮	hyct
瞯	hueg
瞰	hnbt
瞱	hagf
瞲	hcbk
瞳	hujf
瞴	hrlo
瞵	hoqh
瞶	hkhm
瞷	hujg
瞸	haas
瞹	hept
瞺	hwgj
瞻	hqdy
瞼	hwgw
瞽	fkuh
瞾	hhpa
瞿	hhwy
矀	htmt
矁	hton
矂	hkks
矃	hpns
矄	htgo
矅	hnwy
矆	hawc
矇	hape
矈	hrpy
矉	hpgm
矊	hxrh
矋	hday
矌	hyaw
矍	hhwc
矎	hqmt
矏	hthy
矐	hfwy
矑	hhal
矒	halh
矓	hued
矔	haky
矕	xyxh
矖	hgmx
矗	fhfh
矘	hipo
矙	hunt
矚	hnij
矛	cbtr
矜	cbtn
矝	cbtc
矞	cbtk
矟	cbte
矠	cbtj
矡	cbtc
矢	tdu
矣	ctdu
矤	xtdy
知	tdkg
矦	qdtd
矧	tdxh
矨	tdtd
矩	tdan
矪	tdte
矫	tdtj
矬	tdwf
短	tdgu
矮	tdtv
矯	tdtk
矰	tduj
矱	tdac
矲	tdlx
石	dgtg
矴	dsh
矵	djh
矶	dmn
矷	dbg
矸	dfh
矹	dgqn
矺	dtan
矻	dtnn
矼	dag
矽	dqy
矾	dmyy
矿	dyt
砀	dnrt
码	dcg
砂	ditt
砃	dmyg
砄	dnwy
砅	diy
砆	dfwy
砇	dyy
砈	ddbn
砉	dhdf
砊	dymn
砋	dhg
砌	davn
砍	dqwy
砎	dwjh
砏	dwvn
砐	deyy
砑	daht
砒	dxxn
砓	dmcy
研	dgah
砕	dvfh
砖	dfny
砗	dlh
砘	dgbn
砙	dgnn
砚	dmqn
砛	dwyn
砜	dmqy
砝	dfcy
砞	dgsy
砟	dthf
砠	degg
砡	dgyy
砢	dskg
砣	dpxn
砤	dtbn
砥	dqay
砦	hxdf
砧	dhkg
砨	dynn
砩	dxjh
砪	dxgu
砫	dygg
砬	dug
砭	dtpy
砮	vcdf
砯	dyiy
砰	dguh
砱	dwyc
砲	dqnn
砳	ddg
破	dhcy
砵	dsgg
砶	drg
砷	djhh
砸	damh
砹	daqy
砺	dddn
砻	dxdf
砼	dwag
砽	deh
砾	dqiy
砿	dycy
础	dbmh
硁	dcag
硂	dwgg
硃	driy
硄	diqn
硅	dffg
硆	dwgk
硇	dtlq
硈	dfkg
硉	dvfh
硊	dqdb
硋	dynw
硌	dtkg
硍	dvey
硎	dgaj
硏	dftf
硐	dmgk
硑	duah
硒	dsg
硓	dftx
硔	dawy
硕	ddmy
硖	dguw
硗	datq
硘	dlkg
硙	dmnn
硚	dtdj
硛	dyoy
硜	dgva
硝	dieg
硞	dtfk
硟	dthp
硠	dyve
硡	dpdc
硢	dwty
硣	dftb
硤	ddww
硥	ddne
硦	dgah
硧	dceh
硨	dlh
硩	rrdf
硪	dtrt
硫	dycq
硬	dgjq
硭	dayn
确	dqeh
硯	dhqn
硰	iitd
硱	dlsy
硲	dwwk
硳	dfoy
硴	dawx
硵	dhlq
硶	dmwn
硷	dwgi
硸	dmdf
硹	dswc
硺	deyy
硻	ahnd
硼	deeg
硽	ddjn
硾	dtgf
硿	dpwa
碀	dqvh
碁	adwd
碂	dpfi
碃	dgeg
碄	dssy
碅	dlty
碆	ihcd
碇	dpgh
碈	dqaj
碉	dmfk
碊	daat
碋	dmsk
碌	dviy
碍	djgf
碎	dywf
碏	dajg
碐	dfwt
碑	drtf
碒	dqg
碓	dwyg
碔	dgah
碕	ddsk
碖	dwga
碗	dpqb
碘	dmaw
碙	dmum
碚	dukg
碛	dgmy
碜	dcde
碝	ddmd
碞	kkkd
碟	dans
碠	dyps
碡	dgxu
碢	dmnk
碣	djqn
碤	damd
碥	dyna
碦	dptk
碧	grdf
碨	dlge
碩	ddmy
碪	dadn
碫	dwdc
碬	dnhc
碭	djgr
碮	djgh
碯	dvtq
碰	duog
碱	ddgt
碲	duph
碳	dmdo
碴	dsjg
碵	dhmy
碶	ddhd
碷	drfh
碸	dmtj
碹	dpgg
確	dpwy
碻	dymk
碼	dcy
碽	damy
碾	dnae
碿	dnie
磀	dubp
磁	duxx
磂	dqyl
磃	drhm
磄	dyvk
磅	dupy
磆	dmeg
磇	dtlx
磈	drqc
磉	dccs
磊	dddf
磋	duda
磌	dfhw
磍	dpdk
磎	dexd
磏	duvo
磐	temd
磑	dmgu
磒	dkmy
磓	dwnp
磔	dqas
磕	dfcl
磖	dnrg
磗	dgef
磘	derm
磙	duce
磚	dgjf
磛	lrdf
磜	dwfi
磝	dgqt
磞	dmee
磟	dnwe
磠	dhlo
磡	dadl
磢	ddqq
磣	dcce
磤	drvc
磥	dlxi
磦	dsfi
磧	dgmy
磨	yssd
磩	ddht
磪	dmwy
磫	dtwh
磬	fnmd
磭	ddfe
磮	dmwa
磯	dxxt
磰	dudk
磱	dool
磲	dias
磳	dulj
磴	dwgu
磵	dujg
磶	dvqo
磷	doqh
磸	dusd
磹	dsjh
磺	damw
磻	dtol
磼	dwys
磽	dffq
磾	dkkf
磿	dttd
礀	dueg
礁	dwyo
礂	dfkk
礃	dipr
礄	dtdk
礅	dybt
礆	dwgw
礇	dtmd
礈	duep
礉	dryt
礊	lbmd
礋	dlff
礌	dflg
礍	dajn
礎	dssh
礏	dogw
礐	wfqd
礑	dipl
礒	dugt
礓	dglg
礔	dnku
礕	nkud
礖	dwfw
礗	dpgm
礘	djxo
礙	dxth
礚	dafl
礛	dahl
礜	wfgd
礝	dfdj
礞	dape
礟	dcqq
礠	duxn
礡	dagf
礢	dude
礣	dalt
礤	dawi
礥	dahm
礦	dyaw
礧	dlll
礨	llld
礩	drrm
礪	dday
礫	dxrs
礬	sqqd
礭	dfwy
礮	dcuq
礯	dooi
礰	ddth
礱	uegd
礲	dued
礳	dysd
礴	daif
礵	dfsh
礶	daky
礷	daal
礸	dtfm
礹	dkkt
示	fiu
礻	pyi
礼	pynn
礽	pyen
社	pyfg
礿	pyqy
祀	pynn
祁	pybh
祂	pybn
祃	pycg
祄	pywj
祅	pytd
祆	pygd
祇	pyqa
祈	pyrh
祉	pyhg
祊	pyyn
祋	pymc
祌	pykh
祍	pytf
祎	pyfh
祏	pydg
祐	pydk
祑	pyrw
祒	pyvk
祓	pydc
祔	pywf
祕	pynt
祖	pyeg
祗	pyqy
祘	fifi
祙	pyfi
祚	pytf
祛	pyfc
祜	pydg
祝	pykq
神	pyjh
祟	bmfi
祠	pynk
祡	hxfi
祢	pyqi
祣	pyte
祤	pyng
祥	pyud
祦	pykd
祧	pyiq
票	sfiu
祩	pyri
祪	pyqb
祫	pywk
祬	pygf
祭	wfiu
祮	pyfk
祯	pyhm
祰	pytk
祱	pyuq
祲	pyvc
祳	pyde
祴	pyaa
祵	pyls
祶	pyut
祷	pydf
祸	pykw
祹	pyqm
祺	pyaw
祻	pyld
祼	pyjs
祽	pyyf
祾	pyft
祿	pyxi
禀	ylki
禁	ssfi
禂	pymk
禃	pyfh
禄	pyvi
禅	pyuf
禆	pyrf
禇	pyfj
禈	pypl
禉	pyug
禊	pydd
禋	pysf
禌	pyux
禍	pymk
禎	pyhm
福	pygl
禐	pyec
禑	pyjy
禒	pyxe
禓	pyjr
禔	pyjh
禕	pynh
禖	pyas
禗	pyln
禘	pyuh
禙	pyue
禚	pyuo
禛	pyfw
禜	oopi
禝	pylt
禞	pyyk
禟	pyyk
禠	pyrm
禡	pycy
禢	pyjn
禣	pygf
禤	pyln
禥	pyaf
禦	trhi
禧	pyfk
禨	pyxt
禩	pylw
禪	pykf
禫	pysj
禬	pywj
禭	pyup
禮	pymu
禯	pyme
禰	pygq
禱	pyff
禲	pydy
禳	pyye
禴	pywa
禵	pyjm
禶	pytm
禷	pyom
禸	mci
禹	tkmy
禺	jmhy
离	ybmc
禼	hlqc
禽	wybc
禾	tttt
禿	tqb
秀	teb
私	tcy
秂	twu
秃	tmb
秄	tbg
秅	ttan
秆	tfh
秇	tvyy
秈	tmh
秉	tgvi
秊	ttfj
秋	toy
秌	oty
种	tkhh
秎	twvn
秏	ttfn
秐	tfcy
科	tufh
秒	titt
秓	tfcy
秔	tymn
秕	txxn
秖	tqan
秗	ttdy
秘	tntt
秙	tdg
秚	tufh
秛	thcy
秜	tnxn
秝	tty
秞	tmg
租	tegg
秠	tgig
秡	tdcy
秢	twyc
秣	tgsy
秤	tguh
秥	ipbf
秦	dwtu
秧	tmdy
秨	tthf
秩	trwy
秪	tqay
秫	tsyy
秬	tang
秭	ttnt
秮	tckg
积	tkwy
称	tqiy
秱	tmgk
秲	tffy
秳	ttdg
秴	twgk
秵	tldy
秶	uqwt
秷	tgcf
秸	tfkg
秹	twtf
秺	tpta
移	tqqy
秼	triy
秽	tmqy
秾	tpey
秿	tgey
稀	tqdh
稁	yptu
稂	tyve
稃	tebg
稄	tcwt
稅	twkq
稆	tkkg
稇	tlsy
稈	tjfh
稉	tgjq
稊	tuxt
程	tkgg
稌	twty
稍	tieg
税	tukq
稏	tgfg
稐	twga
稑	tfwf
稒	tldg
稓	tajg
稔	twyn
稕	tybg
稖	tukg
稗	trtf
稘	tadw
稙	tfhg
稚	twyg
稛	tlty
稜	tfwt
稝	teeg
稞	tjsy
稟	ylkt
稠	tmfk
稡	tywf
稢	takg
稣	qgty
稤	tyiy
稥	tojf
稦	tnhh
稧	tdhd
稨	tyna
稩	tleg
稪	ttjt
稫	tgkl
稬	tdmd
稭	txxr
種	ttgf
稯	tqbt
稰	tnhe
稱	temf
稲	tehj
稳	tqvn
稴	tuvo
稵	tuxx
稶	take
稷	tlwt
稸	tyxl
稹	tfhw
稺	tnuh
稻	tevg
稼	tpey
稽	tdnj
稾	ymkt
稿	tymk
穀	fpgc
穁	tabg
穂	tgmn
穃	tpwk
穄	twfi
穅	tyvi
穆	trie
穇	tcce
穈	ysst
穉	tnih
穊	tvcq
穋	tnwe
穌	qoty
積	tgmy
穎	xtdm
穏	tevn
穐	tqjn
穑	tfuk
穒	twvo
穓	tlaw
穔	tamw
穕	twys
穖	txxt
穗	tgjn
穘	tffq
穙	togy
穚	ttdk
穛	twyo
穜	tujf
穝	tjbc
穞	tqgj
穟	tuep
穠	tmae
穡	tfwk
穢	thdt
穣	tufe
穤	tfdj
穥	twfw
穦	tpgm
穧	tyjg
穨	tmkm
穩	tean
穪	tgwq
穫	tawc
穬	tyaw
穭	tqoj
穮	tyno
穯	tfkk
穰	tyke
穱	telf
穲	tgmx
穳	ttfm
穴	pwu
穵	pwnb
究	pwvb
穷	pwlb
穸	pwqu
穹	pwxb
空	pwaf
穻	pwgf
穼	pwsu
穽	pwfj
穾	pwtd
穿	pwat
窀	pwgn
突	pwdu
窂	pwrh
窃	pwav
窄	pwtf
窅	pwhf
窆	pwtp
窇	pwqn
窈	pwxl
窉	pwgw
窊	pwry
窋	pwbm
窌	pwqb
窍	pwan
窎	pwqg
窏	pwif
窐	pwff
窑	pwrm
窒	pwgf
窓	pwcn
窔	pwuq
窕	pwiq
窖	pwtk
窗	pwtt
窘	pwvk
窙	pwfb
窚	pwdt
窛	pwfv
窜	pwkh
窝	pwkw
窞	pwqv
窟	pwnm
窠	pwjs
窡	pwcc
窢	pwag
窣	pwyf
窤	pwjx
窥	pwfq
窦	pwfd
窧	pwhj
窨	pwuj
窩	pwmk
窪	pwif
窫	pwdd
窬	pwwj
窭	pwov
窮	pwtx
窯	pwuo
窰	pwem
窱	pwws
窲	pwof
窳	pwry
窴	pwfw
窵	pwwo
窶	pwlv
窷	pwbb
窸	pwtn
窹	pwnk
窺	pwfq
窻	pwtn
窼	pwvs
窽	pwxw
窾	pwfw
窿	pwbg
竀	pwgq
竁	pwtn
竂	pwdi
竃	pwfn
竄	pwvn
竅	pwrt
竆	pwtk
竇	pwfm
竈	pwfx
竉	pwud
竊	pwtc
立	uuuu
竌	umn
竍	ufh
竎	uaj
竏	utfh
竐	umcy
竑	udcy
竒	ukhj
竓	utfn
竔	utah
竕	uwvn
竖	jcuf
竗	uitt
竘	uqkg
站	uhkg
竚	upsh
竛	uwyc
竜	ujnb
竝	uug
竞	ukqb
竟	ujqb
章	ujj
竡	udjg
竢	uctd
竣	ucwt
竤	updc
童	ujff
竦	ugki
竧	utmt
竨	uhjh
竩	upeg
竪	ahnu
竫	uqvh
竬	utky
竭	ujqn
竮	unua
端	umdj
竰	udjf
竱	ugjf
竲	uulj
竳	uwgu
竴	uusf
竵	ugkh
競	ukqq
竷	ujtt
竸	ujqq
竹	ttgh
竺	tff
竻	tlb
竼	tmyu
竽	tgfj
竾	tbb
竿	tfj
笀	tynb
笁	taf
笂	tvyu
笃	tcf
笄	tgaj
笅	tqqu
笆	tcb
笇	tyhu
笈	teyu
笉	tquf
笊	trhy
笋	tvtr
笌	taht
笍	tmwu
笎	tfqb
笏	tqrr
笐	tymb
笑	ttdu
笒	twyn
笓	txxb
笔	ttfn
笕	tmqb
笖	tnyw
笗	ttuu
笘	thkf
笙	ttgf
笚	tlj
笛	tmf
笜	tbmj
笝	tlcu
笞	tckf
笟	trcy
笠	tuf
笡	tegf
笢	tnab
笣	tqnb
笤	tvkf
笥	tngk
符	twfu
笧	tmmg
笨	tsgf
笩	twau
笪	tjgf
笫	ttnt
第	txht
笭	twyc
笮	tthf
笯	tvcu
笰	txjj
笱	tqkf
笲	tcaj
笳	tlkf
笴	tskf
笵	tibb
笶	ttdu
笷	tqtb
笸	takf
笹	tanb
笺	tgr
笻	tabj
笼	tdxb
笽	tlf
笾	tlpu
笿	ttkf
筀	tfff
筁	tmaf
筂	tibb
筃	tldu
筄	tiqb
筅	ttfq
筆	tvfh
筇	tabj
筈	ttdf
等	tffu
筊	tuqu
筋	telb
筌	twgf
筍	tqjf
筎	tvkf
筏	twar
筐	tagf
筑	tamy
筒	tmgk
筓	tftf
答	twgk
筕	ttfh
策	tgmi
筗	twkh
筘	trkf
筙	tdiu
筚	txxf
筛	tjgh
筜	tivf
筝	tqvh
筞	tpsu
筟	tebf
筠	tfqu
筡	twtu
筢	trcb
筣	ttjj
筤	tyve
筥	tkkf
筦	tpfq
筧	thqb
筨	twyk
筩	tcej
筪	talj
筫	tmu
筬	tdnt
筭	tgaj
筮	taww
筯	tegl
筰	twtf
筱	twht
筲	tief
筳	ttfp
筴	tdww
筵	tthp
筶	ttfk
筷	tnnw
筸	tjfj
筹	tdtf
筺	tagy
筻	tgjq
筼	tkmu
筽	tkgd
签	twgi
筿	ttsu
简	tujf
箁	tukf
箂	tsww
箃	tbcu
箄	trtf
箅	tlgj
箆	tmwx
箇	tldf
箈	tick
箉	trkl
箊	tywu
箋	taar
箌	tgcj
箍	trah
箎	tham
箏	tevh
箐	tgef
箑	tgvh
箒	tvph
箓	tviu
箔	tirf
箕	tadw
箖	tssu
算	thaj
箘	tltu
箙	tebc
箚	twgj
箛	tbry
箜	tpwa
箝	traf
箞	tudb
箟	tjxx
箠	ttgf
管	tpnn
箢	tpqb
箣	tgmj
箤	tywf
箥	tihc
箦	tgmu
箧	tagw
箨	trch
箩	tlqu
箪	tujf
箫	tvij
箬	tadk
箭	tuej
箮	tpgg
箯	twgq
箰	tqjb
箱	tshf
箲	titq
箳	tnua
箴	tdgt
箵	tith
箶	tdef
箷	tytb
箸	tftj
箹	txqy
箺	tdwj
箻	ttvh
箼	tngf
箽	ttgf
箾	tiej
箿	tkbf
節	tvcb
篁	trgf
篂	tjtg
篃	tnhf
範	tlbb
篅	tmdj
篆	txeu
篇	tyna
篈	tfff
築	tams
篊	tiaw
篋	tadw
篌	twnd
篍	ttou
篎	thit
篏	tafw
篐	tsah
篑	tkhm
篒	twye
篓	tovf
篔	tkmu
篕	tfcl
篖	tyvk
篗	twyc
篘	tqbt
篙	tymk
篚	tadd
篛	txuu
篜	tbio
篝	tfjf
篞	tijf
篟	twge
篠	twhs
篡	thdc
篢	tamu
篣	tupy
篤	tcu
篥	tssu
篦	ttlx
篧	tpwy
篨	tbwt
篩	twnh
篪	trhm
篫	tamr
篬	twyk
篭	tujn
篮	tjtl
篯	tqgr
篰	tukb
篱	tybc
篲	tdhv
篳	tjaf
篴	tepu
篵	ttwh
篶	tgho
篷	ttdp
篸	tcce
篹	thdb
篺	trrf
篻	tsfi
篼	tqrq
篽	ttrb
篾	tldt
篿	tgjf
簀	tgmu
簁	tthh
簂	tlag
簃	ttqq
簄	tync
簅	tutg
簆	tpfc
簇	tytd
簈	tntf
簉	ttfp
簊	tadf
簋	tvel
簌	tgkw
簍	tlvf
簎	traj
簏	tynx
簐	tlqw
簑	tyke
簒	thdc
簓	tmfe
簔	tyge
簕	tafl
簖	tonr
簗	tivs
簘	tvoj
簙	tfgf
簚	tlah
簛	tadr
簜	tijr
簝	tdui
簞	tkkf
簟	tsjj
簠	tgel
簡	tujf
簢	tuyu
簣	tkhm
簤	tlmu
簥	ttdk
簦	twgu
簧	tamw
簨	tnnw
簩	tool
簪	taqj
簫	tvfj
簬	tkhk
簭	tawk
簮	tfwj
簯	tsaw
簰	tthf
簱	tyaw
簲	terf
簳	tfjf
簴	thaw
簵	tltk
簶	tpyi
簷	tqdy
簸	tadc
簹	tipl
簺	tpff
簻	tmnp
簼	trff
簽	twgw
簾	tyuo
簿	tigf
籀	trql
籁	tgkm
籂	twyh
籃	tahl
籄	takm
籅	twfw
籆	tawc
籇	type
籈	tsfn
籉	tfkf
籊	tnwy
籋	tgwq
籌	tfnf
籍	tdij
籎	txth
籏	tytw
籐	teui
籑	thde
籒	trgl
籓	titl
籔	tlvt
籕	tsql
籖	tfag
籗	tfwy
籘	teui
籙	tqvi
籚	thal
籛	tqaa
籜	trlf
籝	tyny
籞	ttri
籟	tgkm
籠	tued
籡	trww
籢	twgt
籣	tugi
籤	twwg
籥	twga
籦	tqtf
籧	thap
籨	twgw
籩	tthp
籪	txxr
籫	ttfm
籬	tyby
籭	tgmx
籮	tlxy
籯	tyny
籰	thhc
籱	tfwy
籲	twgm
米	oyty
籴	tyou
籵	ofh
籶	omn
籷	otan
籸	onfh
籹	ovg
籺	otnn
类	odu
籼	omh
籽	obg
籾	ovyy
籿	ofy
粀	odyy
粁	otfh
粂	qyou
粃	oxxn
粄	orcy
粅	oqrt
粆	oitt
粇	oymn
粈	onfg
粉	owvn
粊	xxou
粋	ovfh
粌	oxhh
粍	otfn
粎	onyy
粏	odyy
粐	oynt
粑	ocn
粒	oug
粓	oafg
粔	oang
粕	org
粖	ogsy
粗	oegg
粘	ohkg
粙	omg
粚	otbn
粛	vojk
粜	bmou
粝	oddn
粞	osg
粟	sou
粠	oawy
粡	omgk
粢	uqwo
粣	ommg
粤	tlon
粥	xoxn
粦	oqah
粧	oyfg
粨	odjg
粩	oftx
粪	oawu
粫	odmj
粬	omag
粭	owgk
粮	oyve
粯	ohqn
粰	oebg
粱	ivwo
粲	hqco
粳	ogjq
粴	ojfg
粵	tmtn
粶	oviy
粷	oqoy
粸	oadw
粹	oywf
粺	ortf
粻	odey
粼	oqab
粽	opfi
精	ogeg
粿	ojsy
糀	oawx
糁	ocde
糂	oadn
糃	ojgr
糄	oyna
糅	ocbs
糆	odmd
糇	ownd
糈	onhe
糉	oqbt
糊	odeg
糋	ouej
糌	othj
糍	ouxx
糎	odjf
糏	onie
糐	ogef
糑	oxuu
糒	oate
糓	fpgc
糔	ocyj
糕	ougo
糖	oyvk
糗	othd
糘	opey
糙	otfp
糚	oanf
糛	oipf
糜	ysso
糝	occe
糞	olaw
糟	ogmj
糠	oyvi
糡	oujq
糢	oajd
糣	oaqj
糤	oaet
糥	odmj
糦	ofkk
糧	ojgf
糨	oxkj
糩	owgj
糪	nkuo
糫	olge
糬	olfj
糭	oqot
糮	oahl
糯	ofdj
糰	olgf
糱	btwo
糲	oday
糳	oguo
糴	tyoy
糵	awno
糶	bmoy
糷	oaui
糸	xiu
糹	xnny
糺	xnn
系	txiu
糼	xln
糽	xsh
糾	xnhh
糿	xvn
紀	xnn
紁	xcyy
紂	xfy
紃	xkh
約	xqyy
紅	xag
紆	xgfh
紇	xtnn
紈	xvyy
紉	xvyy
紊	yxiu
紋	xyy
紌	xdnn
納	xmwy
紎	thd
紏	xufh
紐	xnfg
紑	xgiy
紒	xwjh
紓	xcbh
純	xgbn
紕	xxxn
紖	xxhh
紗	xitt
紘	xdcy
紙	xqan
級	xeyy
紛	xwvn
紜	xfcy
紝	xtfg
紞	xpqn
紟	xwyn
素	gxiu
紡	xyn
索	fpxi
紣	xvfh
紤	xrh
紥	rnxi
紦	xcn
紧	jcxi
紨	xwfy
紩	xrwy
紪	xhxn
紫	hxxi
紬	xmg
紭	xxcy
紮	snxi
累	lxiu
細	xlg
紱	xdcy
紲	xann
紳	xjhh
紴	xhcy
紵	xpsh
紶	xfcy
紷	xwyc
紸	xygg
紹	xvkg
紺	xafg
紻	xmdy
紼	xxjh
紽	xpxn
紾	xwet
紿	xckg
絀	xbmh
絁	xtbn
終	xtuy
絃	xyxy
組	xegg
絅	xmkg
絆	xufh
絇	xqkg
絈	xrg
絉	xsyy
絊	xsgg
絋	xycy
経	xcfg
絍	xwtf
絎	xtfh
絏	xjxt
結	xfkg
絑	xriy
絒	xyth
絓	xffg
絔	xdjg
絕	dggg
絖	xiqn
絗	xlkg
絘	xuqw
絙	xgjg
絚	xghg
絛	whti
絜	dhvi
絝	xdfn
絞	xuqy
絟	xwgg
絠	xdeg
絡	xtkg
絢	xqjg
絣	xuah
絤	xsg
絥	xwdy
給	xwgk
絧	xmgk
絨	xadt
絩	xiqn
絪	xldy
絫	ccci
絬	xtdg
絭	udxi
絮	vkxi
絯	xynw
絰	xgcf
統	xycq
絲	xxiy
絳	xtah
絴	xudh
絵	xwfc
絶	xqcn
絷	rvyi
絸	xhqn
絹	xkeg
絺	xqdh
絻	xqkq
絼	xeet
絽	xkkg
絾	xdnt
絿	xfiy
綀	xgki
綁	xdtb
綂	xyqn
綃	xieg
綄	xpfq
綅	xvpc
綆	xgjq
綇	xsgg
綈	xuxt
綉	xten
綊	xdww
綋	xpdc
綌	xwwk
綍	xfpb
綎	xtfp
綏	xevg
綐	xukq
綑	xlsy
綒	xebg
經	xgva
綔	dfni
綕	xfny
綖	xthp
綗	xmwk
綘	xtdh
継	xonn
続	xfpq
綛	xvyn
綜	xpfi
綝	xssy
綞	xtgf
綟	xynd
綠	xxgi
綡	xyiy
綢	xmfk
綣	xudb
綤	vkbi
綥	xlgj
綦	adwi
綧	xybg
綨	xadw
綩	xpqb
綪	xgeg
綫	xaat
綬	xepc
維	xwyg
綮	ynti
綯	xqrm
綰	xpnn
綱	xmum
網	xmun
綳	xeeg
綴	xccc
綵	xesy
綶	xjsy
綷	xywf
綸	xwga
綹	xthk
綺	xdsk
綻	xpgh
綼	xrtf
綽	xhjh
綾	xfwt
綿	xrmh
緀	xgvv
緁	xgvh
緂	xooy
緃	xwwh
緄	xjxx
緅	xbcy
緆	xjqr
緇	xvlg
緈	xfuf
緉	xgmy
緊	ahni
緋	xdjd
緌	xtvg
緍	xqaj
緎	xakg
総	xwcn
緐	txgi
緑	xviy
緒	xftj
緓	xamd
緔	ximk
緕	xyjg
緖	xfty
緗	xshg
緘	xdgt
緙	xafh
線	xriy
緛	xdmd
緜	rmhi
緝	xkbg
緞	xwdc
緟	xtgf
締	xuph
緡	xnaj
緢	xalg
緣	xxey
緤	xans
緥	xwks
緦	xlny
緧	xusg
編	xyna
緩	xefc
緪	xngg
緫	xqrn
緬	xdmd
緭	xleg
緮	xtjt
緯	xnhh
緰	xwgj
緱	xwnd
緲	xhit
緳	ydhi
練	xgli
緵	xqbt
緶	xwgq
緷	xplh
緸	xsfg
緹	xjgh
緺	xmnk
緻	xgct
緼	xjlg
緽	xhmy
緾	xdjf
緿	xckn
縀	xnhc
縁	xvey
縂	xukn
縃	xnhe
縄	xjjn
縅	xdgt
縆	xngg
縇	xpgg
縈	oopi
縉	xgoj
縊	xuwl
縋	xwnp
縌	xubp
縍	xupy
縎	xmeg
縏	temi
縐	xqbt
縑	xuvo
縒	xuda
縓	xdri
縔	xccs
縕	xlwl
縖	xpdk
縗	xyke
縘	xexd
縙	xabg
縚	xevg
縛	xgef
縜	xkmy
縝	xfhw
縞	xymk
縟	xdff
縠	fpgc
縡	xpuh
縢	eudi
縣	hiti
縤	xgxi
縥	xdwt
縦	xtuh
縧	xwhs
縨	xjiq
縩	xwfi
縪	xjaf
縫	xtdp
縬	xdht
縭	xybc
縮	xpwj
縯	xpgw
縰	xthh
縱	xtwh
縲	xlxi
縳	xgjf
縴	xyxh
縵	xjlc
縶	fufi
縷	xlvg
縸	xajd
縹	xsfi
縺	xlpy
縻	yssi
縼	xyth
總	xtln
績	xgmy
縿	xcce
繀	xmwy
繁	txgi
繂	xyxf
繃	xmee
繄	atdi
繅	xvjs
繆	xnwe
繇	ermi
繈	xxcj
繉	xhiq
繊	xfag
繋	lmci
繌	xtlt
繍	xvoj
繎	xqdo
繏	xnnw
繐	xgjn
繑	xtdk
繒	xulj
繓	xjbc
織	xuaj
繕	xudk
繖	xaet
繗	xoqh
繘	xcbk
繙	xtol
繚	xdui
繛	gxij
繜	xusf
繝	xueg
繞	xffq
繟	xkkf
繠	nnni
繡	xvfj
繢	xkhm
繣	xvfg
繤	ahdi
繥	xfkk
繦	xxkj
繧	xffc
繨	xfup
繩	xxg
繪	xwgj
繫	lbmi
繬	xfwk
繭	amhj
繮	xglg
繯	xlge
繰	xkks
繱	xaqn
繲	xqeh
繳	xryt
繴	nkui
繵	xylg
繶	xujn
繷	xmae
繸	xuep
繹	xlff
繺	xqvo
繻	xfdj
繼	xxxn
繽	xpgm
繾	xkhp
繿	xahl
纀	xwoy
纁	xtgo
纂	thdi
纃	xyjg
纄	xatp
纅	xxrs
纆	xlff
纇	oxim
纈	xfkm
纉	xfwm
纊	xyaw
纋	xdet
續	xflm
纍	llli
纎	xfag
纏	xyjf
纐	xuqm
纑	xhal
纒	xyjf
纓	xmmv
纔	xqky
纕	xyke
纖	xwwg
纗	xmwk
纘	xtfm
纙	xlxy
纚	xgmx
纛	gxgi
纜	xahq
纝	xlli
纞	xxyn
纟	xxxx
纠	xnhh
纡	xgfh
红	xag
纣	xfy
纤	xtfh
纥	xtnn
约	xqyy
级	xeyy
纨	xvyy
纩	xyt
纪	xnn
纫	xvyy
纬	xfnh
纭	xfcy
纮	xdcy
纯	xgbn
纰	xxxn
纱	xitt
纲	xmqy
纳	xmwy
纴	xtfg
纵	xwwy
纶	xwxn
纷	xwvn
纸	xqan
纹	xyy
纺	xyn
纻	xpgg
纼	xxhh
纽	xnfg
纾	xcbh
线	xgt
绀	xafg
绁	xann
绂	xdcy
练	xanw
组	xegg
绅	xjhh
细	xlg
织	xkwy
终	xtuy
绉	xqvg
绊	xufh
绋	xxjh
绌	xbmh
绍	xvkg
绎	xcfh
经	xcag
绐	xckg
绑	xdtb
绒	xadt
结	xfkg
绔	xdfn
绕	xatq
绖	xgcf
绗	xtfh
绘	xwfc
给	xwgk
绚	xqjg
绛	xtah
络	xtkg
绝	xqcn
绞	xuqy
统	xycq
绠	xgjq
绡	xieg
绢	xkeg
绣	xten
绤	xwwk
绥	xevg
绦	xtsy
继	xonn
绨	xuxt
绩	xgmy
绪	xftj
绫	xfwt
绬	xamd
续	xfnd
绮	xdsk
绯	xdjd
绰	xhjh
绱	ximk
绲	xjxx
绳	xkjn
维	xwyg
绵	xrmh
绶	xepc
绷	xeeg
绸	xmfk
绹	xqrm
绺	xthk
绻	xudb
综	xpfi
绽	xpgh
绾	xpnn
绿	xviy
缀	xccc
缁	xvlg
缂	xafh
缃	xshg
缄	xdgt
缅	xdmd
缆	xjtq
缇	xjgh
缈	xhit
缉	xkbg
缊	xjlg
缋	xkhm
缌	sawp
缍	xtgf
缎	xwdc
缏	xwgq
缐	xriy
缑	xwnd
缒	xwnp
缓	xefc
缔	xuph
缕	xovg
编	xyna
缗	xnaj
缘	xxey
缙	xgoj
缚	xgef
缛	xdff
缜	xfhw
缝	xtdp
缞	xyke
缟	xymk
缠	xyjf
缡	xybc
缢	xuwl
缣	xuvo
缤	xprw
缥	xsfi
缦	xjlc
缧	xlxi
缨	xmmv
缩	xpwj
缪	xnwe
缫	xvjs
缬	xfkm
缭	xdui
缮	xudk
缯	xulj
缰	xglg
缱	xkhp
缲	xkks
缳	xlge
缴	xryt
缵	xtfm
缶	rmk
缷	rmbh
缸	rmag
缹	rmou
缺	rmnw
缻	rmgn
缼	rmqw
缽	rmsg
缾	rmua
缿	rmrk
罀	rmiq
罁	rmmm
罂	mmrm
罃	oopm
罄	fnmm
罅	rmhh
罆	rmxm
罇	rmuf
罈	rmsj
罉	rmir
罊	lbmm
罋	yxtm
罌	mmrm
罍	lllm
罎	rmjc
罏	rmhl
罐	rmay
网	mqqi
罒	lhng
罓	mqi
罔	muyn
罕	pwfj
罖	lwyu
罗	lqu
罘	lgiu
罙	pwsu
罚	lyjj
罛	lrcy
罜	lygf
罝	legf
罞	lcbt
罟	ldf
罠	lnab
罡	lghf
罢	lfcu
罣	lfff
罤	luxt
罥	lkef
罦	lebf
罧	lssu
罨	ldjn
罩	lhjj
罪	ldjd
罫	lffh
罬	lccc
罭	lakg
置	lfhf
罯	lujf
罰	lyjj
罱	lfmf
署	lftj
罳	llnu
罴	lfco
罵	lcu
罶	lqyl
罷	lcex
罸	lyfu
罹	lnwy
罺	lvjs
罻	lnff
罼	ljaf
罽	ldoj
罾	lulj
罿	lujf
羀	mqql
羁	lafc
羂	lxke
羃	lajh
羄	lxhj
羅	lxwy
羆	lceo
羇	lafk
羈	lafc
羉	lxyi
羊	udj
羋	gkgh
羌	udnb
羍	dudj
美	ugdu
羏	udet
羐	gjgy
羑	ugqy
羒	udwv
羓	udcn
羔	ugou
羕	ugyi
羖	udmc
羗	udnc
羘	eudh
羙	ugou
羚	udwc
羛	ugxj
羜	udps
羝	udqy
羞	udnf
羟	udca
羠	udgw
羡	uguw
羢	udad
羣	vtkd
群	vtkd
羥	udga
羦	udpq
羧	udct
羨	ugiw
義	ugtt
羪	udye
羫	udpa
羬	uddt
羭	udwj
羮	ugoy
羯	udjn
羰	udmo
羱	uddi
羲	ugtt
羳	udtl
羴	udud
羵	udfm
羶	udyg
羷	udww
羸	ynky
羹	ugod
羺	udfj
羻	udyt
羼	nudd
羽	nnyg
羾	nag
羿	naj
翀	nkhh
翁	wcnf
翂	nwvn
翃	dcng
翄	nfcy
翅	fcnd
翆	nvfj
翇	ndcu
翈	lng
翉	sgng
翊	ung
翋	nug
翌	nuf
翍	nhcy
翎	wycn
翏	nwer
翐	nrwy
翑	nqkg
習	nrf
翓	fkng
翔	udng
翕	wgkn
翖	wgkn
翗	qqng
翘	atgn
翙	mqng
翚	nplj
翛	whtn
翜	ndww
翝	pdcn
翞	nyiy
翟	nwyf
翠	nywf
翡	djdn
翢	mfkn
翣	nuvf
翤	kman
翥	ftjn
翦	uejn
翧	pgjn
翨	njgh
翩	ynmn
翪	nqbt
翫	nrfq
翬	nplj
翭	nwnd
翮	gkmn
翯	nymk
翰	fjwn
翱	rdfn
翲	sfin
翳	atdn
翴	glfl
翵	nwvo
翶	rifn
翷	oqan
翸	famn
翹	fffn
翺	thin
翻	toln
翼	nlaw
翽	hdgn
翾	lgkn
翿	fnan
耀	iqny
老	ftxb
耂	fte
考	ftgn
耄	ftxn
者	ftjf
耆	ftxj
耇	ftqk
耈	ftxk
耉	fttk
耊	ftgf
耋	ftxf
而	dmjj
耍	dmjv
耎	dmjd
耏	dmje
耐	dmjf
耑	mdmj
耒	dii
耓	dish
耔	dibg
耕	difj
耖	diit
耗	ditn
耘	difc
耙	dicn
耚	dihc
耛	dick
耜	dinn
耝	dieg
耞	dilk
耟	dian
耠	diwk
耡	diel
耢	dial
耣	diwa
耤	diaj
耥	diik
耦	dijy
耧	diov
耨	didf
耩	diff
耪	diuy
耫	digm
耬	dilv
耭	dixt
耮	diol
耯	diac
耰	didt
耱	diyd
耲	diye
耳	bghg
耴	bnn
耵	bsh
耶	bbh
耷	dbf
耸	wwbf
耹	bwyn
耺	bfcy
耻	bhg
耼	bmfg
耽	bpqn
耾	bdcy
耿	boy
聀	bat
聁	bwvn
聂	bccu
聃	bmfg
聄	bwet
聅	btdy
聆	bwyc
聇	bghg
聈	bxln
聉	bbmh
聊	bqtb
聋	dxbf
职	bkwy
聍	bpsh
聎	biqn
聏	bdmj
聐	bfkg
聑	bbg
聒	btdg
聓	amyb
联	budy
聕	btfk
聖	bkgf
聗	bdww
聘	bmgn
聙	bgeg
聚	bcti
聛	brtf
聜	bpwa
聝	bakg
聞	ubd
聟	tdkb
聠	buah
聡	bwcn
聢	bpgh
聣	bvqn
聤	byps
聥	btky
聦	bqrn
聧	bwgd
聨	bxxa
聩	bkhm
聪	bukn
聫	bxxd
聬	bwcn
聭	brqc
聮	bxxo
聯	bxxg
聰	btln
聱	gqtb
聲	fnmb
聳	twwb
聴	bfln
聵	bkhm
聶	bbbf
職	buaj
聸	bqdy
聹	bpns
聺	bpwi
聻	ilrb
聼	nbfn
聽	bgfn
聾	uegb
聿	vfhk
肀	vhk
肁	ynvh
肂	gqvh
肃	vijk
肄	xtdh
肅	vfjk
肆	dvfh
肇	ynth
肈	ynah
肉	mwwi
肊	enn
肋	eln
肌	emn
肍	evn
肎	pef
肏	tymw
肐	etnn
肑	eqyy
肒	evyy
肓	ynef
肔	ebn
肕	evyy
肖	ief
肗	evg
肘	efy
肙	kef
肚	efg
肛	eag
肜	eet
肝	efh
肞	ecyy
肟	efnn
肠	enrt
股	emcy
肢	efcy
肣	ewyn
肤	efwy
肥	ecn
肦	ewvn
肧	egiy
肨	edhh
肩	yned
肪	eyn
肫	egbn
肬	ednn
肭	emwy
肮	eymn
肯	hef
肰	edy
肱	edcy
育	ycef
肳	eqrt
肴	qdef
肵	erh
肶	exxn
肷	eqwy
肸	ewfh
肹	ewgn
肺	egmh
肻	hpef
肼	efjh
肽	edyy
肾	jcef
肿	ekhh
胀	etay
胁	elwy
胂	ejhh
胃	lef
胄	mef
胅	erwy
胆	ejgg
胇	exjh
胈	edcy
胉	erg
胊	eqkg
胋	ehkg
背	uxef
胍	ercy
胎	eckg
胏	etnt
胐	ebmh
胑	ekwy
胒	enxn
胓	eguh
胔	hxmw
胕	ewfy
胖	eufh
胗	ewet
胘	eyxy
胙	ethf
胚	egig
胛	elh
胜	etgg
胝	eqay
胞	eqnn
胟	exgu
胠	efcy
胡	deg
胢	eskg
胣	etbn
胤	txen
胥	nhef
胦	emdy
胧	edxn
胨	eaiy
胩	ehhy
胪	ehnt
胫	ecag
胬	vcmw
胭	eldy
胮	etah
胯	edfn
胰	egxw
胱	eiqn
胲	eynw
胳	etkg
胴	emgk
胵	egcf
胶	euqy
胷	qqbe
胸	eqqb
胹	edmj
胺	epvg
胻	etfh
胼	euah
能	cexx
胾	famw
胿	effg
脀	bige
脁	eiqn
脂	exjg
脃	eqcn
脄	edoy
脅	llle
脆	eqdb
脇	elll
脈	erey
脉	eyni
脊	iwef
脋	vvve
脌	erhf
脍	ewfc
脎	eqsy
脏	eyfg
脐	eyjh
脑	eybh
脒	eoy
脓	epey
脔	yomw
脕	eqkq
脖	efpb
脗	eqrk
脘	epfq
脙	efiy
脚	efcb
脛	egva
脜	edhg
脝	eybh
脞	ewwf
脟	eefy
脠	ethp
脡	etfp
脢	etxu
脣	dfee
脤	edfe
脥	edww
脦	eany
脧	ecwt
脨	egki
脩	whte
脪	eqdh
脫	ewkq
脬	eebg
脭	ekgg
脮	eevg
脯	egey
脰	egku
脱	eukq
脲	eniy
脳	eiqb
脴	egik
脵	ekgd
脶	ekmw
脷	etjh
脸	ewgi
脹	edey
脺	eywf
脻	egvh
脼	egmy
脽	ewyg
脾	ertf
脿	egey
腀	ewga
腁	etff
腂	ejsy
腃	eudb
腄	etgf
腅	eooy
腆	emaw
腇	etvg
腈	egeg
腉	evqn
腊	eajg
腋	eywy
腌	edjn
腍	ewyn
腎	ahne
腏	eccc
腐	ywfw
腑	eywf
腒	endg
腓	edjd
腔	epwa
腕	epqb
腖	egji
腗	emgj
腘	elgy
腙	epfi
腚	epgh
腛	engf
腜	eafs
腝	edmd
腞	exey
腟	epgf
腠	edwd
腡	emnk
腢	ejmy
腣	euph
腤	eujg
腥	ejtg
腦	evtq
腧	ewgj
腨	emdj
腩	efmf
腪	eplh
腫	etgf
腬	ecbs
腭	ekkn
腮	elny
腯	erfh
腰	esvg
腱	evfp
腲	elge
腳	ewwb
腴	evwy
腵	enhc
腶	ewdc
腷	egkl
腸	ejgr
腹	etjt
腺	eriy
腻	eafm
腼	edmd
腽	ejlg
腾	eudc
腿	evep
膀	eupy
膁	euvo
膂	ytee
膃	elwl
膄	evhc
膅	eyvk
膆	egxi
膇	ewnp
膈	egkh
膉	euwl
膊	egef
膋	oope
膌	eiwe
膍	etlx
膎	eexd
膏	ypke
膐	ytew
膑	eprw
膒	eakk
膓	etjr
膔	eynx
膕	elag
膖	etdp
膗	emwy
膘	esfi
膙	exkj
膚	hale
膛	eipf
膜	eajd
膝	eswi
膞	egjf
膟	eyxf
膠	enwe
膡	eudh
膢	elvg
膣	epwf
膤	efvg
膥	gsdw
膦	eoqh
膧	eujf
膨	efke
膩	eafm
膪	eupk
膫	edui
膬	etfn
膭	ekhm
膮	effq
膯	ewgu
膰	etol
膱	euaj
膲	ewyo
膳	eudk
膴	erlo
膵	eayf
膶	eugg
膷	extb
膸	edap
膹	efam
膺	ywwe
膻	eylg
膼	emnp
膽	eqdy
膾	ewgj
膿	emae
臀	nawe
臁	eyuo
臂	nkue
臃	eyxy
臄	ehae
臅	elqj
臆	eujn
臇	ewym
臈	eajn
臉	ewgw
臊	ekks
臋	naww
臌	efkc
臍	eyjg
臎	enyf
臏	epgm
臐	etgo
臑	efdj
臒	eawc
臓	eadt
臔	eahm
臕	eyno
臖	wfme
臗	epay
臘	evln
臙	eauo
臚	ehal
臛	efwy
臜	etfm
臝	ynky
臞	ehhy
臟	eadt
臠	xyxw
臡	akfw
臢	etfm
臣	ahnh
臤	ahnc
臥	ahnw
臦	nhah
臧	dndt
臨	ahnk
臩	nhaj
自	thd
臫	thnn
臬	thsu
臭	thdu
臮	thwu
臯	thif
臰	thgx
臱	thpy
臲	thsb
至	gcff
致	gcft
臵	gcfk
臶	gcfb
臷	fagf
臸	gcff
臹	gcft
臺	fkpf
臻	gcft
臼	vth
臽	qvf
臾	vwi
臿	tfvd
舀	evf
舁	vaj
舂	dwvf
舃	vgno
舄	vqou
舅	vllb
舆	wflw
與	wfgw
興	wfmw
舉	wfgh
舊	awyv
舋	wfmg
舌	tdd
舍	wfkf
舎	wfkf
舏	tdnh
舐	tdqa
舑	tdmf
舒	wfkb
舓	tdjr
舔	tdgn
舕	tdoo
舖	wfky
舗	wfky
舘	wfkn
舙	tdtd
舚	tdqy
舛	qahh
舜	epqh
舝	nhvh
舞	rlgh
舟	tei
舠	tevn
舡	teag
舢	temh
舣	teyq
舤	temy
舥	tecn
舦	tedy
舧	tety
舨	terc
舩	tewc
航	teym
舫	teyn
般	temc
舭	texx
舮	teyn
舯	tekh
舰	temq
舱	tewb
舲	tewc
舳	temg
舴	tetf
舵	tepx
舶	terg
舷	teyx
舸	tesk
船	temk
舺	telh
舻	tehn
舼	teaw
舽	teth
舾	tesg
舿	tedn
艀	teeb
艁	tetk
艂	teth
艃	tejf
艄	teie
艅	tewt
艆	teye
艇	tetp
艈	teyq
艉	tenn
艊	terh
艋	tebl
艌	tewn
艍	tend
艎	terg
艏	teuh
艐	teqt
艑	teya
艒	tejh
艓	teas
艔	teyc
艕	teuy
艖	teua
艗	teul
艘	tevc
艙	tewk
艚	tegj
艛	telv
艜	teah
艝	tefv
艞	tetq
艟	teuf
艠	tewu
艡	teil
艢	tefk
艣	tehl
艤	teut
艥	tekt
艦	teal
艧	teac
艨	teae
艩	teyj
艪	teqj
艫	tehl
艬	teqy
艭	tewc
艮	vei
良	yvei
艰	cvey
艱	akfe
色	qcb
艳	dhqc
艴	xjqc
艵	uaqc
艶	magc
艷	dhdc
艸	btbh
艹	aghh
艺	anb
艻	alb
艼	asj
艽	avb
艾	aqu
艿	aeb
芀	avb
芁	amb
节	abj
芃	amyu
芄	avyu
芅	aau
芆	acyu
芇	amhj
芈	gjgh
芉	afj
芊	atfj
芋	agfj
芌	afnb
芍	aqyu
芎	axb
芏	aff
芐	aghu
芑	anb
芒	aynb
芓	abf
芔	bhbh
芕	aqu
芖	adu
芗	axtr
芘	axxb
芙	afwu
芚	agbn
芛	avtr
芜	afqb
芝	apu
芞	arnb
芟	amcu
芠	ayu
芡	aqwu
芢	awff
芣	agiu
芤	abnb
芥	awjj
芦	aynr
芧	acbj
芨	aeyu
芩	awyn
芪	aqab
芫	afqb
芬	awvb
芭	acb
芮	amwu
芯	anu
芰	afcu
花	awxb
芲	awxb
芳	ayb
芴	aqrr
芵	anwu
芶	aqcu
芷	ahf
芸	afcu
芹	arj
芺	atdu
芻	qbtt
芼	atfn
芽	aaht
芾	agmh
芿	aweb
苀	aymb
苁	awwu
苂	aou
苃	adcu
苄	ayhu
苅	aqjj
苆	aavb
苇	afnh
苈	adlb
苉	aaqb
苊	adbb
苋	amqb
苌	atay
苍	awbb
苎	apgf
苏	alwu
苐	axht
苑	aqbb
苒	amff
苓	awyc
苔	ackf
苕	avkf
苖	amf
苗	alf
苘	amkf
苙	auf
苚	aej
苛	askf
苜	ahf
苝	auxb
苞	aqnb
苟	aqkf
苠	anab
苡	anyw
苢	anhn
苣	aanf
苤	agig
若	adkf
苦	adf
苧	apsj
苨	anxb
苩	arf
苪	agmw
苫	ahkf
苬	alwu
苭	axlb
苮	awmj
苯	asgf
苰	axcu
英	amdu
苲	athf
苳	atuu
苴	aegf
苵	arwu
苶	awiu
苷	aaff
苸	atuh
苹	aguh
苺	axgu
苻	awfu
苼	atgf
苽	arcy
苾	antr
苿	afiu
茀	axjj
茁	abmj
茂	adnt
范	aibb
茄	alkf
茅	acbt
茆	aqtb
茇	adcu
茈	ahxb
茉	agsu
茊	argf
茋	aqay
茌	awff
茍	gjgk
茎	acaf
茏	adxb
茐	aqry
茑	aqyg
茒	aqbj
茓	apwu
茔	apff
茕	apnf
茖	atkf
茗	aqkf
茘	avvv
茙	aadr
茚	aqgb
茛	aveu
茜	asf
茝	aahh
茞	aahh
茟	avfh
茠	awsu
茡	apbf
茢	agqj
茣	akgd
茤	aqqu
茥	afff
茦	agmi
茧	aju
茨	auqw
茩	argk
茪	aiqb
茫	aiyn
茬	adhf
茭	auqu
茮	ahiu
茯	awdu
茰	ajqu
茱	ariu
茲	axxu
茳	aiaf
茴	alkf
茵	aldu
茶	awsu
茷	awar
茸	abf
茹	avkf
茺	aycq
茻	btbh
茼	amgk
茽	awkh
茾	agaj
茿	aamy
荀	aqjf
荁	agjg
荂	adfn
荃	awgf
荄	aynw
荅	awgk
荆	agaj
荇	atfh
荈	aqah
草	ajj
荊	agaj
荋	admj
荌	apvf
荍	anht
荎	agcf
荏	awtf
荐	adhb
荑	agxw
荒	aynq
荓	auaj
荔	alll
荕	aelb
荖	aftx
荗	adyt
荘	auff
荙	adpu
荚	aguw
荛	aatq
荜	axxf
荝	amjj
荞	atdj
荟	awfc
荠	ayjj
荡	ainr
荢	apgf
荣	apsu
荤	aplj
荥	apiu
荦	aprh
荧	apou
荨	avfu
荩	anyu
荪	abiu
荫	abef
荬	anud
荭	axaf
荮	axfu
药	axqy
荰	asff
荱	antn
荲	ajff
荳	agku
荴	arfw
荵	avyn
荶	akwn
荷	awsk
荸	afpb
荹	ahir
荺	afqu
荻	aqto
荼	awtu
荽	aevf
荾	acwt
荿	adnt
莀	adfe
莁	aaww
莂	aklj
莃	aqdh
莄	agjq
莅	awuf
莆	agey
莇	aegl
莈	aimc
莉	atjj
莊	anhf
莋	awtf
莌	aukq
莍	afiy
莎	aiit
莏	arit
莐	aipq
莑	atdh
莒	akkf
莓	atxu
莔	alwm
莕	askf
莖	agva
莗	alj
莘	auj
莙	avtk
莚	athp
莛	atfp
莜	awht
莝	awwf
莞	apfq
莟	awyk
莠	ateb
莡	akhu
莢	adww
莣	aynn
莤	asgf
莥	aqtf
莦	aief
莧	ahqb
莨	ayve
莩	aebf
莪	atrt
莫	ajdu
莬	aqkq
莭	avcb
莮	allb
莯	aisu
莰	afqw
莱	agou
莲	alpu
莳	ajfu
莴	akmw
莵	atky
莶	awgi
获	aqtd
莸	aqtn
莹	apgy
莺	apqg
莻	aekx
莼	axgn
莽	adaj
莾	adfa
莿	agmj
菀	apqb
菁	agef
菂	arqy
菃	aian
菄	agji
菅	apnn
菆	abcu
菇	avdf
菈	aruf
菉	aviu
菊	aqou
菋	akfi
菌	altu
菍	awyn
菎	ajxx
菏	aisk
菐	oguy
菑	avlf
菒	ajsu
菓	ajsu
菔	aebc
菕	awga
菖	ajjf
菗	armf
菘	aswc
菙	atgf
菚	aaar
菛	auf
菜	aesu
菝	ardc
菞	atqt
菟	aqky
菠	aihc
菡	abib
菢	arqn
菣	aahc
菤	audb
菥	asrj
菦	arpu
菧	ayqy
菨	auvf
菩	aukf
菪	apdf
菫	agkg
菬	aivk
菭	aick
菮	ayvw
華	agaf
菰	abry
菱	afwt
菲	adjd
菳	aqf
菴	adjn
菵	amun
菶	adwh
菷	avph
菸	aywu
菹	aieg
菺	ayne
菻	assu
菼	aoou
菽	ahic
菾	agdn
菿	agcj
萀	aham
萁	aadw
萂	atkf
萃	aywf
萄	aqrm
萅	agbj
萆	artf
萇	adeu
萈	ahqy
萉	aecb
萊	asww
萋	agvv
萌	ajef
萍	aigh
萎	atvf
萏	aqvf
萐	agvh
萑	awyf
萒	aucq
萓	apeg
萔	arvk
萕	ayjf
萖	avqb
萗	apfi
萘	adfi
萙	aspq
萚	arch
萛	ahaj
萜	amhk
萝	alqu
萞	amwx
萟	atvy
萠	aeef
萡	airf
萢	aiqn
萣	apgh
萤	apju
营	apkk
萦	apxi
萧	avij
萨	abut
萩	atou
萪	atuf
萫	atjf
萬	ajmy
萭	atky
萮	awgj
萯	aqmu
萰	agli
萱	apgg
萲	aefc
萳	afmf
萴	amjj
萵	amnk
萶	adwj
萷	aiej
萸	avwu
萹	ayna
萺	ajhf
萻	aujf
萼	akkn
落	aitk
萾	aecl
萿	aitd
葀	artd
葁	augv
葂	aqkl
葃	ajtf
葄	aetf
葅	awwg
葆	awks
葇	acbs
葈	acks
葉	aans
葊	awga
葋	aeqk
葌	avvv
葍	agkl
葎	atvh
葏	aivh
葐	awvl
葑	afff
葒	axaf
葓	aiaw
葔	awnd
葕	atih
葖	apwd
著	aftj
葘	agvl
葙	ashf
葚	aadn
葛	ajqn
葜	adhd
葝	agvl
葞	axbf
葟	argf
葠	awvc
葡	aqgy
葢	adyl
董	atgf
葤	axfu
葥	auej
葦	anhh
葧	afpl
葨	alge
葩	arcb
葪	aqej
葫	adef
葬	agqa
葭	anhc
葮	awdc
葯	axqy
葰	awct
葱	aqrn
葲	ariu
葳	adgt
葴	adgt
葵	awgd
葶	ayps
葷	aplj
葸	alnu
葹	aytb
葺	akbf
葻	amtj
葼	aqbt
葽	asvf
葾	aqbn
葿	anhf
蒀	ajlf
蒁	asyp
蒂	auph
蒃	axeu
蒄	apff
蒅	aivs
蒆	aamv
蒇	admt
蒈	axxr
蒉	akhm
蒊	awxx
蒋	auqf
蒌	aovf
蒍	ayto
蒎	aire
蒏	apsg
蒐	arqc
蒑	arvc
蒒	awnh
蒓	axgn
蒔	ajff
蒕	alwl
蒖	afhw
蒗	aiye
蒘	avkr
蒙	apge
蒚	agkh
蒛	armw
蒜	afii
蒝	adri
蒞	aiwu
蒟	auqk
蒠	athn
蒡	aupy
蒢	abwt
蒣	atwt
蒤	aiwt
蒥	aqyl
蒦	awyc
蒧	adht
蒨	awge
蒩	ateg
蒪	agef
蒫	auda
蒬	apqy
蒭	aqbt
蒮	apwy
蒯	aeej
蒰	atec
蒱	argy
蒲	aigy
蒳	axmw
蒴	aube
蒵	aexd
蒶	axwv
蒷	akmu
蒸	abio
蒹	auvo
蒺	autd
蒻	axuu
蒼	awyk
蒽	aldn
蒾	aopu
蒿	aymk
蓀	abti
蓁	adwt
蓂	apju
蓃	avhc
蓄	ayxl
蓅	aiyq
蓆	ayah
蓇	amef
蓈	ayvb
蓉	apwk
蓊	awcn
蓋	afcl
蓌	awwt
蓍	aftj
蓎	ayvk
蓏	arcy
蓐	adff
蓑	ayke
蓒	alfj
蓓	awuk
蓔	augo
蓕	asff
蓖	atlx
蓗	atfh
蓘	auce
蓙	aywf
蓚	awhe
蓛	agmt
蓜	asgn
蓝	ajtl
蓞	aevf
蓟	aqgj
蓠	aybc
蓡	aivc
蓢	ayve
蓣	acbm
蓤	auft
蓥	apqf
蓦	ajdc
蓧	awhs
蓨	awhe
蓩	acbl
蓪	acep
蓫	aepu
蓬	atdp
蓭	aydn
蓮	alpu
蓯	atwh
蓰	athh
蓱	aiua
蓲	aakk
蓳	aakg
蓴	agjf
蓵	argh
蓶	akwy
蓷	arwy
蓸	agmj
蓹	atrb
蓺	afwy
蓻	afuy
蓼	anwe
蓽	ajaf
蓾	ahlo
蓿	apwj
蔀	aukb
蔁	aujj
蔂	alxi
蔃	axkj
蔄	aukf
蔅	auvf
蔆	aift
蔇	avcq
蔈	asfi
蔉	auke
蔊	aojf
蔋	aihc
蔌	agkw
蔍	aynx
蔎	aymc
蔏	aumk
蔐	aumd
蔑	aldt
蔒	avto
蔓	ajlc
蔔	aqgl
蔕	aaqh
蔖	ahag
蔗	ayao
蔘	acce
蔙	ayth
蔚	anff
蔛	aqef
蔜	agqt
蔝	ahou
蔞	alvf
蔟	aytd
蔠	axtu
蔡	awfi
蔢	aihv
蔣	anhf
蔤	apnm
蔥	atln
蔦	awvo
蔧	adhv
蔨	alub
蔩	apgw
蔪	alrj
蔫	agho
蔬	anhq
蔭	abwc
蔮	alag
蔯	abgi
蔰	aync
蔱	aqsc
蔲	apft
蔳	aige
蔴	ayss
蔵	adat
蔶	agmu
蔷	afuk
蔸	aqrq
蔹	awgt
蔺	auwy
蔻	apfc
蔼	ayjn
蔽	aumt
蔾	atqs
蔿	aeto
蕀	agmi
蕁	avaf
蕂	aeul
蕃	atol
蕄	aunu
蕅	aijy
蕆	admt
蕇	akkf
蕈	asjj
蕉	awyo
蕊	annn
蕋	ahhh
蕌	ajjj
蕍	aiwj
蕎	atdk
蕏	aqtj
蕐	agwh
蕑	auef
蕒	almu
蕓	affc
蕔	afuc
蕕	aqtg
蕖	aias
蕗	akhk
蕘	affq
蕙	agjn
蕚	akkn
蕛	atut
蕜	adjn
蕝	axqc
蕞	ajbc
蕟	awxc
蕠	avki
蕡	afam
蕢	akhm
蕣	aeph
蕤	aetg
蕥	aahy
蕦	aedm
蕧	attt
蕨	aduw
蕩	aijr
蕪	arlo
蕫	aujf
蕬	axxi
蕭	avfj
蕮	avqo
蕯	abtg
蕰	aijl
蕱	atie
蕲	aujr
蕳	aujf
蕴	axjl
蕵	aqwe
蕶	afwc
蕷	acbm
蕸	anhp
蕹	ayxy
蕺	akbt
蕻	adaw
蕼	advh
蕽	amae
蕾	aflf
蕿	aoec
薀	aill
薁	atmd
薂	aryt
薃	aiyk
薄	aigf
薅	avdf
薆	aept
薇	atmt
薈	awgj
薉	ahdt
薊	aqoj
薋	auqm
薌	axtb
薍	aecn
薎	alpa
薏	aujn
薐	atft
薑	aglg
薒	ahqo
薓	aivc
薔	afwk
薕	ayuo
薖	amnp
薗	alfe
薘	afup
薙	atdy
薚	agqr
薛	awnu
薜	anku
薝	aqdy
薞	agqe
薟	awgw
薠	aodm
薡	ahnn
薢	aqeh
薣	afkc
薤	agqg
薥	alqj
薦	ayno
薧	aypx
薨	alpx
薩	abug
薪	ausr
薫	atgo
薬	aris
薭	atrf
薮	aovt
薯	alfj
薰	atgo
薱	aogf
薲	apgm
薳	afkp
薴	apns
薵	afnf
薶	aeef
薷	afdj
薸	aisi
薹	afkf
薺	ayjf
薻	aivs
薼	aynf
薽	asfn
薾	agwq
薿	axth
藀	aooo
藁	ayms
藂	abci
藃	aymw
藄	aadi
藅	alyj
藆	apfr
藇	awfw
藈	ahwd
藉	adij
藊	atya
藋	anwy
藌	apnj
藍	aahl
藎	avhl
藏	adnt
藐	aeeq
藑	aqmt
藒	atjn
藓	aqgd
藔	apdi
藕	adiy
藖	aahm
藗	agkp
藘	ahan
藙	auec
藚	aflm
藛	apvo
藜	atqi
藝	afwc
藞	addd
藟	alll
藠	arrr
藡	aump
藢	atmt
藣	alcx
藤	aeui
藥	axrs
藦	aysr
藧	axec
藨	ayno
藩	aitl
藪	alvt
藫	aisj
藬	abkm
藭	apwx
藮	aswo
藯	anfn
藰	aqyj
藱	aurc
藲	asak
藳	aymt
藴	axjl
藵	awke
藶	adth
藷	ayfj
藸	aefj
藹	ayjn
藺	auwy
藻	aiks
藼	apgn
藽	ausq
藾	agkm
藿	afwy
蘀	arlf
蘁	agkk
蘂	anns
蘃	ahhs
蘄	akkr
蘅	atqh
蘆	ahal
蘇	aqot
蘈	atmm
蘉	alpc
蘊	axll
蘋	ahim
蘌	atri
蘍	atgl
蘎	afec
蘏	axfm
蘐	ayec
蘑	aysd
蘒	atqn
蘓	atqo
蘔	axtm
蘕	axtp
蘖	awns
蘗	anks
蘘	ayke
蘙	aatn
蘚	aqod
蘛	aade
蘜	aafo
蘝	awgw
蘞	awgt
蘟	aben
蘠	anhk
蘡	ammv
蘢	aued
蘣	aamg
蘤	areo
蘥	awga
蘦	afkk
蘧	ahap
蘨	aeri
蘩	atxi
蘪	ayno
蘫	aial
蘬	awnh
蘭	augi
蘮	aldj
蘯	aijl
蘰	axjc
蘱	aodm
蘲	allf
蘳	aamf
蘴	adhu
蘵	abuj
蘶	atvc
蘷	gjgt
蘸	asgo
蘹	anye
蘺	ayby
蘻	albi
蘼	aysd
蘽	alls
蘾	afye
蘿	alxy
虀	aydg
虁	auht
虂	afkk
虃	aiwg
虄	ajtg
虅	aeuc
虆	alli
虇	axay
虈	akkk
虉	agko
虊	axys
虋	awfv
虌	aumx
虍	hav
虎	hamv
虏	halv
虐	haag
虑	hani
虒	rham
虓	vham
虔	hayi
處	hatm
虖	hath
虗	harg
虘	haeg
虙	hant
虚	haog
虛	hang
虜	hall
虝	hamr
虞	hakd
號	kgnm
虠	uqhm
虡	haow
虢	efhm
虣	gahm
虤	hamm
虥	hama
虦	aahm
虧	hawn
虨	hase
虩	ijim
虪	hamo
虫	jhny
虬	jnn
虭	jvn
虮	jmn
虯	jnhh
虰	jsh
虱	ntji
虲	jhy
虳	jqyy
虴	jtan
虵	jbn
虶	jgfh
虷	jfh
虸	jbg
虹	jag
虺	gqji
虻	jynn
虼	jtnn
虽	kju
虾	jghy
虿	dnju
蚀	qnjy
蚁	jyqy
蚂	jcg
蚃	xtju
蚄	jyn
蚅	jdbn
蚆	jcn
蚇	jnyy
蚈	jgah
蚉	yju
蚊	jyy
蚋	jmwy
蚌	jdhh
蚍	jxxn
蚎	jjg
蚏	jeg
蚐	jqug
蚑	jfcy
蚒	jmyg
蚓	jxhh
蚔	jqan
蚕	gdju
蚖	jfqn
蚗	ggll
蚘	jdnn
蚙	jwyn
蚚	jrh
蚛	jkhh
蚜	jaht
蚝	jtfn
蚞	jsy
蚟	jgg
蚠	wvju
蚡	jwvn
蚢	jymn
蚣	jwcy
蚤	cyju
蚥	jwqy
蚦	jmfg
蚧	jwjh
蚨	jfwy
蚩	bhgj
蚪	jufh
蚫	jqnn
蚬	jmqn
蚭	jnxn
蚮	jway
蚯	jrgg
蚰	jmg
蚱	jthf
蚲	jguh
蚳	jqay
蚴	jxln
蚵	jskg
蚶	jafg
蚷	jang
蚸	jryy
蚹	jwfy
蚺	jmfg
蚻	snju
蚼	jqkg
蚽	jgig
蚾	jhcy
蚿	jyxy
蛀	jygg
蛁	jvkg
蛂	jdcy
蛃	jgmw
蛄	jdg
蛅	jhkg
蛆	jegg
蛇	jpxn
蛈	jrwy
蛉	jwyc
蛊	jlf
蛋	nhju
蛌	jrcy
蛍	ipju
蛎	jddn
蛏	jcfg
蛐	jmag
蛑	jcrh
蛒	jtkg
蛓	faji
蛔	jlkg
蛕	jdeg
蛖	jdne
蛗	wnnj
蛘	judh
蛙	jffg
蛚	jgqj
蛛	jriy
蛜	jwvt
蛝	jvey
蛞	jtdg
蛟	juqy
蛠	jlll
蛡	jng
蛢	juah
蛣	jfkg
蛤	jwgk
蛥	jqqy
蛦	jgxw
蛧	jmqq
蛨	jdjg
蛩	amyj
蛪	dhvj
蛫	jqdb
蛬	awju
蛭	jgcf
蛮	yoju
蛯	jftx
蛰	rvyj
蛱	jguw
蛲	jatq
蛳	jjgh
蛴	jyjh
蛵	jgva
蛶	jefy
蛷	jfiy
蛸	jieg
蛹	jceh
蛺	jdww
蛻	jwkq
蛼	jlh
蛽	jmy
蛾	jtrt
蛿	jwyk
蜀	lqju
蜁	jtnh
蜂	jtdh
蜃	dfej
蜄	jdfe
蜅	jgey
蜆	jhqn
蜇	rrju
蜈	jkgd
蜉	jebg
蜊	jtjh
蜋	jyve
蜌	jxxf
蜍	jwty
蜎	jkeg
蜏	jten
蜐	jfcl
蜑	thpj
蜒	jthp
蜓	jtfp
蜔	jqlg
蜕	jukq
蜖	jmjd
蜗	jkmw
蜘	jtdk
蜙	jswc
蜚	djdj
蜛	jndg
蜜	pntj
蜝	adwj
蜞	jadw
蜟	jyce
蜠	jlty
蜡	jajg
蜢	jblg
蜣	judn
蜤	srju
蜥	jsrh
蜦	jwga
蜧	jynd
蜨	jgvh
蜩	jmfk
蜪	jqrm
蜫	jjxx
蜬	jbib
蜭	jqvg
蜮	jakg
蜯	jdwh
蜰	ecju
蜱	jrtf
蜲	jtvg
蜳	jybg
蜴	jjqr
蜵	jjgg
蜶	jywf
蜷	judb
蜸	ahnj
蜹	jamw
蜺	jvqn
蜻	jgeg
蜼	jwyg
蜽	jgmy
蜾	jjsy
蜿	jpqb
蝀	jgji
蝁	gfgj
蝂	jthc
蝃	jccc
蝄	jmun
蝅	gdgj
蝆	jgkf
蝇	jkjn
蝈	jlgy
蝉	jujf
蝊	jpgh
蝋	jimh
蝌	jtuf
蝍	jvcb
蝎	jjqn
蝏	jyps
蝐	jjhg
蝑	jnhe
蝒	jdmd
蝓	jwgj
蝔	jxxr
蝕	wpjy
蝖	jpgg
蝗	jrgg
蝘	jajv
蝙	jyna
蝚	jcbs
蝛	jdgt
蝜	jqmy
蝝	jxey
蝞	jnhg
蝟	jleg
蝠	jgkl
蝡	jdmd
蝢	jdmy
蝣	jytb
蝤	jusg
蝥	cbtj
蝦	jnhc
蝧	jamd
蝨	nfjj
蝩	jtgf
蝪	jjgr
蝫	jftj
蝬	jqbt
蝭	jjgh
蝮	jtjt
蝯	jefc
蝰	jdff
蝱	ynjj
蝲	jgkj
蝳	jgxu
蝴	jdeg
蝵	toju
蝶	jans
蝷	jyut
蝸	jmnk
蝹	jjlg
蝺	jtky
蝻	jfmf
蝼	jovg
蝽	jdwj
蝾	japs
蝿	jjjn
螀	uqfj
螁	jvep
螂	jyvb
螃	jupy
螄	jwnh
螅	jthn
螆	juxx
螇	jexd
螈	jdri
螉	jwcn
螊	juvo
螋	jvhc
螌	temj
融	gkmj
螎	jgkh
螏	jutd
螐	jwno
螑	jthd
螒	fjwj
螓	jdwt
螔	jrhm
螕	jtlx
螖	jmeg
螗	jyvk
螘	jmgu
螙	sjju
螚	cexj
螛	jpdk
螜	fpgj
螝	jrqc
螞	jcy
螟	jpju
螠	juwl
螡	yjju
螢	oopj
螣	eudj
螤	yjjw
螥	jwyk
螦	jgxi
螧	jftj
螨	jagw
螩	jwhs
螪	jumk
螫	fotj
螬	jgmj
螭	jybc
螮	jaqh
螯	gqtj
螰	jynx
螱	nfij
螲	jpwf
螳	jipf
螴	bgjj
螵	jsfi
螶	anjj
螷	yrtj
螸	wwkj
螹	jlrh
螺	jlxi
螻	jlvg
螼	jakg
螽	tujj
螾	jpgw
螿	nhdj
蟀	jyxf
蟁	najj
蟂	jwvs
蟃	jjlc
蟄	fufj
蟅	jyao
蟆	jajd
蟇	ajdj
蟈	jlag
蟉	jnwe
蟊	cbtj
蟋	jton
蟌	jtln
蟍	jtjs
蟎	jamy
蟏	javj
蟐	jiph
蟑	jujh
蟒	jada
蟓	jqje
蟔	jlfo
蟕	jhxe
蟖	jadr
蟗	gkhj
蟘	jwam
蟙	juaj
蟚	fkuj
蟛	jfke
蟜	jtdk
蟝	jias
蟞	umij
蟟	jdui
蟠	jtol
蟡	jeto
蟢	jfkk
蟣	jxxt
蟤	jnnw
蟥	jamw
蟦	jfam
蟧	jool
蟨	dubj
蟩	jduw
蟪	jgjn
蟫	jsjh
蟬	jkkf
蟭	jwyo
蟮	judk
蟯	jffq
蟰	jvfj
蟱	jrlo
蟲	jjju
蟳	jvaf
蟴	adwj
蟵	jdgf
蟶	jbkg
蟷	jipl
蟸	ejju
蟹	qevj
蟺	jylg
蟻	jugt
蟼	aqkj
蟽	jfup
蟾	jqdy
蟿	lbmj
蠀	juqm
蠁	xtyj
蠂	jaas
蠃	ynky
蠄	jwyc
蠅	jxg
蠆	ajmj
蠇	jajy
蠈	madj
蠉	jlge
蠊	jyuo
蠋	jlqj
蠌	jlff
蠍	jjqw
蠎	jada
蠏	jqeh
蠐	jyjg
蠑	joos
蠒	gwmj
蠓	jape
蠔	jype
蠕	jfdj
蠖	jawc
蠗	jnwy
蠘	jfay
蠙	jpgm
蠚	adkj
蠛	jalt
蠜	sqqj
蠝	jlll
蠞	tvcj
蠟	jvln
蠠	dmjj
蠡	xejj
蠢	dwjj
蠣	jday
蠤	usgj
蠥	btwj
蠦	jhal
蠧	fpdj
蠨	javj
蠩	jyfj
蠪	uegj
蠫	eejj
蠬	jued
蠭	tdhj
蠮	jatn
蠯	yrtj
蠰	jyke
蠱	jjjl
蠲	uwlj
蠳	jmmv
蠴	jalj
蠵	jmwk
蠶	aqaj
蠷	jhhy
蠸	jaky
蠹	gkhj
蠺	gdgj
蠻	xyxj
蠼	jhhc
蠽	iwyj
蠾	jnij
蠿	vxxj
血	tld
衁	yntl
衂	tlvy
衃	tlgi
衄	tlnf
衅	tluf
衆	tlti
衇	tlre
衈	tlbg
衉	tltk
衊	tlat
衋	vfhl
行	tfhh
衍	tifh
衎	tffh
衏	tfqh
衐	tanh
衑	twyh
衒	tyxh
術	tsyh
衔	tqfh
衕	tmgh
衖	tawh
街	tffh
衘	trhh
衙	tgkh
衚	tdeh
衛	tnhh
衜	tuth
衝	ttgh
衞	tnhh
衟	tvdh
衠	tfhh
衡	tqdh
衢	thhh
衣	yeu
衤	pui
补	puhy
衦	pufh
衧	pugf
表	geu
衩	pucy
衪	pubn
衫	puet
衬	pufy
衭	pufw
衮	uceu
衯	puwv
衰	ykge
衱	puey
衲	pumw
衳	puwc
衴	pupq
衵	pujg
衶	pukh
衷	ykhe
衸	puwj
衹	puqa
衺	yahe
衻	pumf
衼	pufc
衽	putf
衾	wyne
衿	puwn
袀	puqu
袁	fkeu
袂	punw
袃	avye
袄	putd
袅	qyne
袆	pufh
袇	pumy
袈	lkye
袉	pupx
袊	puwc
袋	waye
袌	yqne
袍	puqn
袎	puxl
袏	puda
袐	punt
袑	puvk
袒	pujg
袓	pueg
袔	pusk
袕	pupw
袖	pumg
袗	puwe
袘	putb
袙	purg
袚	pudc
袛	puqy
袜	pugs
袝	puwf
袞	ukeu
袟	purw
袠	yrwe
袡	pumf
袢	puuf
袣	puan
袤	ycbe
袥	pudg
袦	pubm
袧	puqk
袨	puyx
袩	puhk
袪	pufc
被	puhc
袬	ycke
袭	dxye
袮	puti
袯	puny
袰	xgue
袱	puwd
袲	yqqe
袳	puqq
袴	pudn
袵	puwf
袶	puth
袷	puwk
袸	pudb
袹	pudj
袺	pufk
袻	pudj
袼	putk
袽	puvk
袾	puri
袿	puff
裀	puld
裁	faye
裂	gqje
裃	puhh
裄	puth
装	ufye
裆	puiv
裇	putl
裈	pupl
裉	puve
裊	wvge
裋	pugu
裌	pudw
裍	puls
裎	pukg
裏	yjfe
裐	puke
裑	putt
裒	yveu
裓	puaa
裔	yemk
裕	puwk
裖	pude
裗	puyq
裘	fiye
裙	puvk
裚	rrye
裛	yceu
補	pugy
裝	nhde
裞	puuq
裟	iite
裠	vtke
裡	pujf
裢	pulp
裣	puwi
裤	puyl
裥	puuj
裦	ywfe
裧	puoo
裨	purf
裩	pujx
裪	puqm
裫	pujg
裬	puft
裭	puhm
裮	pujj
裯	pumk
裰	pucc
裱	puge
裲	pugy
裳	ipke
裴	djde
裵	ydje
裶	pudd
裷	puub
裸	pujs
裹	yjse
裺	pudn
裻	hice
裼	pujr
製	rmhe
裾	pund
裿	pudk
褀	puaw
褁	jseu
褂	pufh
褃	puhe
褄	pugv
褅	puuh
褆	pujh
複	putt
褈	putf
褉	pudd
褊	puya
褋	puas
褌	pupl
褍	pumj
褎	ywfe
褏	ywfe
褐	pujn
褑	puec
褒	ywke
褓	puws
褔	pugl
褕	puwj
褖	puxe
褗	puav
褘	punh
褙	puue
褚	pufj
褛	puov
褜	eqne
褝	puif
褞	pujl
褟	pujn
褠	puff
褡	puak
褢	yrqe
褣	pupk
褤	pufe
褥	pudf
褦	pucx
褧	boye
褨	puua
褩	teme
褪	puvp
褫	purm
褬	pucs
褭	yceu
褮	oope
褯	puyh
褰	pfje
褱	ylie
褲	puyl
褳	pulp
褴	pujl
褵	puyc
褶	punr
褷	puth
褸	pulv
褹	pufy
褺	fufe
褻	yfwe
褼	pusn
褽	nfie
褾	pusi
褿	pugj
襀	pugm
襁	puxj
襂	puce
襃	ywfe
襄	ykke
襅	pujf
襆	puoy
襇	puuj
襈	punw
襉	puue
襊	pujc
襋	pugi
襌	pukf
襍	puws
襎	putl
襏	puwc
襐	puqe
襑	puvf
襒	puut
襓	pufq
襔	puay
襕	puui
襖	putd
襗	pulf
襘	puwj
襙	puks
襚	puup
襛	pume
襜	puqy
襝	puww
襞	nkue
襟	pusi
襠	puil
襡	pulj
襢	puyg
襣	putj
襤	pual
襥	puwy
襦	pufj
襧	pugq
襨	puof
襩	pufm
襪	puat
襫	pudj
襬	pulx
襭	pufm
襮	puji
襯	puuq
襰	pugm
襱	puud
襲	uege
襳	puwg
襴	puui
襵	pubb
襶	pufw
襷	puwr
襸	putm
襹	pugx
襺	puaj
襻	pusr
襼	puac
襽	puai
襾	gmjg
西	sghg
覀	sghg
要	svf
覂	stpu
覃	sjj
覄	swdu
覅	svqr
覆	sttt
覇	safe
覈	sryt
覉	safk
覊	safc
見	hqb
覌	chqn
覍	ihqb
覎	hqbd
規	fwhq
覐	hqqq
覑	thgq
覒	tfnq
覓	ehqb
覔	gihq
覕	nthq
視	pyhq
覗	ngkq
覘	hkhq
覙	qihq
覚	iphq
覛	rehq
覜	iqhq
覝	fohq
覞	hqhq
覟	fnhq
覠	vtkq
覡	awwq
覢	oohq
覣	tvhq
覤	hamq
覥	mawq
覦	wgeq
覧	ahnq
覨	kkfq
覩	ftjq
親	ushq
覫	upyq
覬	mgkq
覭	pjuq
覮	oopq
覯	fjgq
覰	haeq
覱	lrhq
覲	akgq
観	tdhq
覴	wgkq
覵	uehq
覶	ecmq
覷	haoq
覸	ujhq
覹	hqtt
覺	wfqq
覻	hagq
覼	gwmq
覽	ahnq
覾	ptoq
覿	flmq
觀	akkq
见	mqb
观	cmqn
觃	mqbd
规	fwmq
觅	emqb
视	pymq
觇	hkmq
览	jtyq
觉	ipmq
觊	mnmq
觋	awwq
觌	fnuq
觍	mawq
觎	wgeq
觏	fjgq
觐	akgq
觑	haoq
角	qej
觓	qenh
觔	qeln
觕	trqe
觖	qenw
觗	qeqa
觘	qeit
觙	qeey
觚	qery
觛	qejg
觜	hxqe
觝	qeqy
觞	qetr
觟	qeff
觠	udqe
觡	qetk
觢	dhve
解	qevh
觤	qeqb
觥	qeiq
触	qejy
觧	qeud
觨	qeai
觩	qefy
觪	qeuh
觫	qegi
觬	qevq
觭	qedk
觮	qevi
觯	qeuf
觰	qefj
觱	dgke
觲	qeuh
觳	fpgc
觴	qetr
觵	qeaw
觶	qekf
觷	wfqe
觸	qelj
觹	qewm
觺	xtde
觻	qexs
觼	qeqt
觽	qemm
觾	qeao
觿	qemk
言	yyyy
訁	yygg
訂	ysh
訃	yhy
訄	vyd
訅	yvn
訆	ynhh
訇	qyd
計	yfh
訉	ymyy
訊	ynfh
訋	yqyy
訌	yag
訍	ycyy
討	yfy
訏	ygfh
訐	yfh
訑	ybn
訒	yvyy
訓	ykh
訔	myf
訕	ymh
訖	ytnn
託	ytan
記	ynn
訙	yvyy
訚	uyd
訛	ywxn
訜	ywvn
訝	yaht
訞	ytdy
訟	ywcy
訠	yxhh
訡	ywyn
訢	yrh
訣	ynwy
訤	yqqy
訥	ymwy
訦	ypqn
訧	ydnn
訨	yhg
訩	yqbh
訪	yyn
訫	yny
訬	yitt
設	ymcy
訮	ygah
訯	yeyy
訰	ygbn
許	ytfh
訲	ykhh
訳	ynyy
訴	yryy
訵	ylg
訶	yskg
訷	yjhh
訸	yty
訹	ysyy
診	ywet
註	yygg
証	yghg
訽	yqkg
訾	hxyf
訿	yhxn
詀	yhkg
詁	ydg
詂	ywfy
詃	yyxy
詄	yrwy
詅	ywyc
詆	yqay
詇	ymdy
詈	lyf
詉	yvcy
詊	yufh
詋	ykqn
詌	yafg
詍	yann
詎	yang
詏	yxln
詐	ythf
詑	ypxn
詒	yckg
詓	yfcy
詔	yvkg
評	yguh
詖	yhcy
詗	ymkg
詘	ybmh
詙	ydcy
詚	yjgg
詛	yegg
詜	ybhc
詝	ypsh
詞	yngk
詟	dxyf
詠	yyni
詡	yng
詢	yqjg
詣	yxjg
詤	ywnq
詥	ywgk
試	yaag
詧	wyf
詨	yuqy
詩	yffy
詪	yvey
詫	ypta
詬	yrgk
詭	yqdb
詮	ywgg
詯	ythg
詰	yfkg
話	ytdg
該	yynw
詳	yudh
詴	ydeg
詵	ytfq
詶	yyth
詷	ymgk
詸	yoy
詹	qdwy
詺	yqkg
詻	ytkg
詼	ydoy
詽	yftf
詾	yqqb
詿	yffg
誀	ybg
誁	yuah
誂	yiqn
誃	yqqy
誄	ydiy
誅	yriy
誆	yagg
誇	ydfn
誈	ygcf
誉	iwyf
誊	udyf
誋	ynny
誌	yfny
認	yvyn
誎	ygki
誏	yyve
誐	ytrt
誑	yqtg
誒	yctd
誓	rryf
誔	ytfp
誕	ythp
誖	yfpb
誗	ytjh
誘	yten
誙	ygva
誚	yieg
誛	yvpc
誜	ycwt
誝	ywyk
語	ygkg
誟	yftb
誠	ydnt
誡	yaah
誢	yhqn
誣	yaww
誤	ykgd
誥	ytfk
誦	yceh
誧	ygey
誨	ytxu
誩	yyg
說	ywkq
誫	ydfe
説	yukq
読	yfpq
誮	yawx
誯	yjjg
誰	ywyg
誱	ygvh
課	yjsy
誳	ynbm
誴	ypfi
誵	yqde
誶	yywf
誷	ymun
誸	yxyx
誹	ydjd
誺	ysww
誻	yijg
誼	ypeg
誽	yvqn
誾	uyd
調	ymfk
諀	yrtf
諁	yccc
諂	yqvg
諃	yssy
諄	yybg
諅	adwy
諆	yadw
談	yooy
諈	ytgf
諉	ytvg
諊	yqoy
請	ygeg
諌	ygji
諍	yqvh
諎	yajg
諏	ybcy
諐	wkqy
諑	yeyy
諒	yyiy
諓	yaat
諔	yhic
諕	yham
論	ywga
諗	ywyn
諘	ygey
諙	yqaj
諚	ypgh
諛	yvwy
諜	yans
諝	ynhe
諞	yyna
諟	yjgh
諠	ypgg
諡	ywgl
諢	yplh
諣	ymnk
諤	ykkn
諥	ytgf
諦	yuph
諧	yxxr
諨	ygkl
諩	yuog
諪	yyps
諫	ygli
諬	tdny
諭	ywgj
諮	yuqk
諯	ymdj
諰	ylny
諱	ynhh
諲	ysfg
諳	yujg
諴	ydgt
諵	yfmf
諶	yadn
諷	ymtj
諸	yftj
諹	yjgr
諺	yute
諻	yrgg
諼	yefc
諽	yafh
諾	yadk
諿	ykbg
謀	yafs
謁	yjqn
謂	yleg
謃	yjtg
謄	eudy
謅	yqbt
謆	yynn
謇	pfjy
謈	jawy
謉	yrqc
謊	yayq
謋	yqas
謌	yskk
謍	oopy
謎	yopy
謏	yvhc
謐	yntl
謑	yexd
謒	ywyk
謓	yfhw
謔	yhag
謕	yrhm
謖	ylwt
謗	yupy
謘	ynuh
謙	yuvo
謚	yuwl
講	yfjf
謜	ydri
謝	ytmf
謞	yymk
謟	yevg
謠	yqrm
謡	yerm
謢	ywyc
謣	yffn
謤	ysfi
謥	ytln
謦	fnmy
謧	yybc
謨	yajd
謩	ajdy
謪	yumk
謫	yumd
謬	ynwe
謭	yuev
謮	ygmy
謯	yhag
謰	ylpy
謱	ylvg
謲	ycce
謳	yakk
謴	yxfm
謵	ynrg
謶	yyao
謷	gqty
謸	ygqt
謹	yakg
謺	fufy
謻	ytqq
謼	yhah
謽	xkjy
謾	yjlc
謿	yfje
譀	ynbt
譁	yagf
譂	ykkf
譃	yhag
譄	yulj
譅	yvyh
譆	yfkk
譇	ydfj
譈	yybt
證	ywgu
譊	yffq
譋	yueg
譌	yeto
譍	ywwy
譎	ycbk
譏	yxxt
譐	yusf
譑	ytdk
譒	ytol
譓	ygjn
譔	ynnw
譕	yrlo
譖	yaqj
譗	ytwk
識	yuaj
譙	ywyo
譚	ysjh
譛	yfwj
譜	yuoj
譝	yxg
譞	ylge
譟	ykks
譠	yylg
譡	yipl
譢	yuep
譣	ywgw
譤	yryt
譥	ryty
警	aqky
譧	yyuo
譨	ymae
譩	yujn
譪	yajn
譫	yqdy
譬	nkuy
譭	yvac
譮	ywgj
譯	ylff
議	yugt
譱	udyy
譲	yufe
譳	yfdj
譴	ykhp
譵	yogf
譶	yyyf
護	yawc
譸	yfnf
譹	yype
譺	yxth
譻	mmyf
譼	ahny
譽	wfgy
譾	yuen
譿	ydhn
讀	yflm
讁	yump
讂	yqmt
讃	yfwm
讄	ylll
讅	yptl
讆	tnhy
讇	yuqv
讈	ydth
讉	ykhp
變	xyxt
讋	uegy
讌	yauo
讍	ygkk
讎	wyyy
讏	tnhy
讐	wywy
讑	ywga
讒	yqky
讓	yyke
讔	yben
讕	yugi
讖	ywwg
讗	ymwk
讘	ybbb
讙	yaky
讚	ytfm
讛	yafc
讜	yipo
讝	ykkt
讞	yhad
讟	yfly
讠	yyn
计	yfh
订	ysh
讣	yhy
认	ywy
讥	ymn
讦	yfh
讧	yag
讨	yfy
让	yhg
讪	ymh
讫	ytnn
讬	ytan
训	ykh
议	yyqy
讯	ynfh
记	ynn
讱	yvyy
讲	yfjh
讳	yfnh
讴	yaqy
讵	yang
讶	yaht
讷	ymwy
许	ytfh
讹	ywxn
论	ywxn
讻	yqbh
讼	ywcy
讽	ymqy
设	ymcy
访	yyn
诀	ynwy
证	yghg
诂	ydg
诃	yskg
评	yguh
诅	yegg
识	ykwy
诇	ymkg
诈	ythf
诉	yryy
诊	ywet
诋	yqay
诌	yqvg
词	yngk
诎	ybmh
诏	yvkg
诐	yhcy
译	ycfh
诒	yckg
诓	yagg
诔	ydiy
试	yaag
诖	yffg
诗	yffy
诘	yfkg
诙	ydoy
诚	ydnt
诛	yriy
诜	ytfq
话	ytdg
诞	ythp
诟	yrgk
诠	ywgg
诡	yqdb
询	yqjg
诣	yxjg
诤	yqvh
该	yynw
详	yudh
诧	ypta
诨	yplh
诩	yng
诪	ydtf
诫	yaah
诬	yaww
语	ygkg
诮	yieg
误	ykgd
诰	ytfk
诱	yten
诲	ytxu
诳	yqtg
说	yukq
诵	yceh
诶	yctd
请	ygeg
诸	yftj
诹	ybcy
诺	yadk
读	yfnd
诼	yeyy
诽	ydjd
课	yjsy
诿	ytvg
谀	yvwy
谁	ywyg
谂	ywyn
调	ymfk
谄	yqvg
谅	yyiy
谆	yybg
谇	yywf
谈	yooy
谉	ypjh
谊	ypeg
谋	yafs
谌	yadn
谍	yans
谎	yayq
谏	ygli
谐	yxxr
谑	yhag
谒	yjqn
谓	yleg
谔	ykkn
谕	ywgj
谖	yefc
谗	yqku
谘	yuqk
谙	yujg
谚	yute
谛	yuph
谜	yopy
谝	yyna
谞	ynhe
谟	yajd
谠	yipq
谡	ylwt
谢	ytmf
谣	yerm
谤	yupy
谥	yuwl
谦	yuvo
谧	yntl
谨	yakg
谩	yjlc
谪	yumd
谫	yuev
谬	ynwe
谭	ysjh
谮	yaqj
谯	ywyo
谰	yugi
谱	yuoj
谲	ycbk
谳	yfmd
谴	ykhp
谵	yqdy
谶	ywwg
谷	wwkf
谸	tdwk
谹	wwkc
谺	wwkt
谻	wwkt
谼	wwkw
谽	wwkk
谾	wwka
谿	exdk
豀	wwkd
豁	pdhk
豂	wwke
豃	wwkt
豄	wwkm
豅	wwkd
豆	gkuf
豇	gkua
豈	mgku
豉	gkuc
豊	magu
豋	wgku
豌	gkub
豍	gkuf
豎	ahnu
豏	gkuo
豐	dhdu
豑	magt
豒	dhdt
豓	dhdl
豔	dhdl
豕	egty
豖	eyi
豗	gqei
豘	egbn
豙	ueu
豚	eey
豛	emcy
豜	egah
豝	ecn
豞	eqkg
豟	eynn
豠	eegg
象	qjeu
豢	udeu
豣	eftf
豤	evey
豥	eynw
豦	haei
豧	egey
豨	eqdh
豩	eey
豪	ypeu
豫	cbqe
豬	eftj
豭	enhc
豮	efam
豯	eexd
豰	fpgc
豱	ejlg
豲	edri
豳	eemk
豴	eumd
豵	etwh
豶	efam
豷	efpu
豸	eer
豹	eeqy
豺	eeft
豻	eefh
豼	eexx
豽	eemw
豾	eegg
豿	eeqk
貀	eebm
貁	eepw
貂	eevk
貃	eerg
貄	eevh
貅	eews
貆	eegg
貇	eeve
貈	eete
貉	eetk
貊	eedj
貋	eejf
貌	eerq
貍	eejf
貎	eevq
貏	eerf
貐	eewj
貑	eenc
貒	eemj
貓	eeal
貔	eetx
貕	eeed
貖	eeul
貗	eelv
貘	eead
貙	eeak
貚	eekf
貛	eeay
貜	eehc
貝	mhny
貞	hmu
貟	cmu
負	qmu
財	mftt
貢	amu
貣	amu
貤	mbn
貥	mymn
貦	mfqn
貧	wvmu
貨	wxmu
販	mrcy
貪	wynm
貫	xfmu
責	gmu
貭	rfmi
貮	gami
貯	mpsh
貰	anmu
貱	mhcy
貲	hxmu
貳	afmi
貴	khgm
貵	cdmu
貶	mtpy
買	lmu
貸	wamu
貹	mtgg
貺	mkqn
費	xjmu
貼	mhkg
貽	mckg
貾	mqay
貿	qyvm
賀	lkmu
賁	famu
賂	mtkg
賃	wtfm
賄	mdeg
賅	mynw
賆	muah
資	uqwm
賈	smu
賉	mtlg
賊	madt
賋	muqy
賌	yntm
賍	myfg
賎	mdxy
賏	mmy
賐	mcwt
賑	mdfe
賒	mwfi
賓	pgim
賔	pnmu
賕	mfiy
賖	mwty
賗	mkkh
賘	myfy
賙	mmfk
賚	swwm
賛	fwfm
賜	mjqr
賝	mpws
賞	ipkm
賟	mmaw
賠	mukg
賡	yvwm
賢	ahnm
賣	flmu
賤	maat
賥	mywf
賦	mgah
賧	mooy
賨	pfim
賩	mpfi
質	rrmu
賫	fwwm
賬	mdey
賭	mftj
賮	vhgm
賯	mqjb
賰	mdwj
賱	mplh
賲	wksm
賳	mfak
賴	gkim
賵	mjhg
賶	mwyk
賷	fkkm
賸	eudm
賹	muwl
賺	muvo
賻	mgef
購	mfjf
賽	pfjm
賾	ahkm
賿	mnwe
贀	atdm
贁	mmty
贂	mcce
贃	mkkn
贄	fufm
贅	gqtm
贆	mddd
贇	ygam
贈	mulj
贉	msjh
贊	tfqm
贋	dwwm
贌	mogy
贍	mqdy
贎	majy
贏	ynky
贐	mvhl
贑	ujam
贒	ahnm
贓	mdnt
贔	mmmu
贕	qytm
贖	mflm
贗	dwwm
贘	mipm
贙	hamm
贚	mued
贛	ujtm
贜	madt
贝	mhny
贞	hmu
负	qmu
贠	cmu
贡	amu
财	mftt
责	gmu
贤	jcmu
败	mty
账	mtay
货	wxmu
质	rfmi
贩	mrcy
贪	wynm
贫	wvmu
贬	mtpy
购	mqcy
贮	mpgg
贯	xfmu
贰	afmi
贱	mgt
贲	famu
贳	anmu
贴	mhkg
贵	khgm
贶	mkqn
贷	wamu
贸	qyvm
费	xjmu
贺	lkmu
贻	mckg
贼	madt
贽	rvym
贾	smu
贿	mdeg
赀	hxmu
赁	wtfm
赂	mtkg
赃	myfg
资	uqwm
赅	mynw
赆	mnyu
赇	mfiy
赈	mdfe
赉	gomu
赊	mwfi
赋	mgah
赌	mftj
赍	fwwm
赎	mfnd
赏	ipkm
赐	mjqr
赑	mmmu
赒	mmfk
赓	yvwm
赔	mukg
赕	mooy
赖	gkim
赗	mjhg
赘	gqtm
赙	mgef
赚	muvo
赛	pfjm
赜	ahkm
赝	dwwm
赞	tfqm
赟	ygam
赠	mulj
赡	mqdy
赢	ynky
赣	ujtm
赤	fou
赥	foqw
赦	foty
赧	fobc
赨	fojy
赩	foqc
赪	fohm
赫	fofo
赬	fohm
赭	fofj
赮	fonc
赯	foyk
走	fhu
赱	fuyu
赲	fhlv
赳	fhnh
赴	fhhi
赵	fhqi
赶	fhfk
起	fhnv
赸	fhmk
赹	fhqu
赺	fhwn
赻	fhit
赼	fhqw
赽	fhnw
赾	fhrk
赿	fhqa
趀	fhtt
趁	fhwe
趂	fhqi
趃	fhrw
趄	fheg
超	fhvk
趆	fhqy
趇	fhud
趈	fhhk
趉	fhbm
越	fhat
趋	fhqv
趌	fhfk
趍	fhqq
趎	fhri
趏	fhtd
趐	fhnd
趑	fhuw
趒	fhiq
趓	fhms
趔	fhgj
趕	fhjf
趖	fhwf
趗	fhkh
趘	fhnn
趙	fhie
趚	fhgi
趛	fhqd
趜	fhqo
趝	fhwn
趞	fhaj
趟	fhik
趠	fhhj
趡	fhwy
趢	fhvi
趣	fhbc
趤	fhpd
趥	fhug
趦	fhuk
趧	fhjh
趨	fhqt
趩	fhlw
趪	fhaw
趫	fhtk
趬	fhfq
趭	fhwo
趮	fhks
趯	fhny
趰	fhgq
趱	fhtm
趲	fhtm
足	khu
趴	khwy
趵	khqy
趶	khgf
趷	khtn
趸	dnkh
趹	khnw
趺	khfw
趻	khwn
趼	khga
趽	khyn
趾	khhg
趿	khey
跀	kheg
跁	khcn
跂	khfc
跃	khtd
跄	khwb
跅	khry
跆	khck
跇	khan
跈	khwe
跉	khwc
跊	khfi
跋	khdc
跌	khrw
跍	khdg
跎	khpx
跏	khlk
跐	khhx
跑	khqn
跒	khsk
跓	khyg
跔	khqk
跕	khhk
跖	khdg
跗	khwf
跘	khuf
跙	kheg
跚	khmg
跛	khhc
跜	khnx
距	khan
跞	khqi
跟	khve
跠	khgw
跡	khyo
跢	khqq
跣	khtq
跤	khuq
跥	khes
跦	khri
跧	khwg
跨	khdn
跩	khjx
跪	khqb
跫	amyh
跬	khff
跭	khth
跮	khgf
路	khtk
跰	khua
跱	khff
跲	khwk
跳	khiq
跴	khsg
践	khgt
跶	khdp
跷	khaq
跸	khxf
跹	khtp
跺	khms
跻	khyj
跼	khnk
跽	khnn
跾	whth
跿	khfh
踀	khkh
踁	khga
踂	khbn
踃	khie
踄	khhi
踅	rrkh
踆	khct
踇	khtu
踈	khgi
踉	khye
踊	khce
踋	khfb
踌	khdf
踍	khfb
踎	khgk
踏	khij
踐	khaa
踑	khaw
踒	khtv
踓	khwy
踔	khhj
踕	khgh
踖	khaj
踗	khwn
踘	khqo
踙	khbc
踚	khwa
踛	khff
踜	khft
踝	khjs
踞	khnd
踟	khtk
踠	khpb
踡	khub
踢	khjr
踣	khuk
踤	khyf
踥	khuv
踦	khdk
踧	khhc
踨	khwh
踩	khes
踪	khpi
踫	khug
踬	khrm
踭	khqh
踮	khyk
踯	khub
踰	khwj
踱	khyc
踲	khrh
踳	khdj
踴	khcl
踵	khtf
踶	khjh
踷	khfj
踸	khan
踹	khmj
踺	khvp
踻	khmk
踼	khjr
踽	khty
踾	khgl
踿	khto
蹀	khas
蹁	khya
蹂	khcs
蹃	khak
蹄	khuh
蹅	khsg
蹆	khvp
蹇	pfjh
蹈	khev
蹉	khua
蹊	khed
蹋	khjn
蹌	khwk
蹍	khne
蹎	khfw
蹏	khrm
蹐	khie
蹑	khbc
蹒	khaw
蹓	khql
蹔	lrkh
蹕	khjf
蹖	khdv
蹗	khyx
蹘	khne
蹙	dhih
蹚	khif
蹛	khah
蹜	khpj
蹝	khth
蹞	khxm
蹟	khgm
蹠	khyo
蹡	khnf
蹢	khud
蹣	khay
蹤	khth
蹥	khlp
蹦	khme
蹧	khgj
蹨	khqo
蹩	umih
蹪	khkm
蹫	khck
蹬	khwu
蹭	khuj
蹮	khsn
蹯	khtl
蹰	khdf
蹱	khuf
蹲	khuf
蹳	khwc
蹴	khyn
蹵	yidh
蹶	khdw
蹷	dubh
蹸	khoh
蹹	khwn
蹺	khfq
蹻	khtk
蹼	khoy
蹽	khdi
蹾	khyt
蹿	khph
躀	khxm
躁	khks
躂	khfp
躃	khnu
躄	nkuh
躅	khlj
躆	khhe
躇	khaj
躈	khrt
躉	ajmh
躊	khff
躋	khyj
躌	khrh
躍	khny
躎	khgq
躏	khay
躐	khvn
躑	khub
躒	khxs
躓	khrm
躔	khyf
躕	khyf
躖	khxg
躗	tnhh
躘	khud
躙	khuy
躚	khsp
躛	tnhh
躜	khtm
躝	khui
躞	khoc
躟	khye
躠	awnh
躡	khbb
躢	khun
躣	khhy
躤	khaj
躥	khpn
躦	khtm
躧	khgx
躨	khut
躩	khhc
躪	khay
身	tmdt
躬	tmdx
躭	tmdq
躮	tmdv
躯	tmdq
躰	tmdg
躱	tmds
躲	tmds
躳	tmdk
躴	tmde
躵	tmdn
躶	tmds
躷	tmdv
躸	tmdk
躹	tmdo
躺	tmdk
躻	tmda
躼	tmde
躽	tmdv
躾	tmdd
躿	tmdi
軀	tmdk
軁	tmdv
軂	tmdl
軃	tmdf
軄	tmdj
軅	tmdy
軆	tmdu
軇	tmdf
軈	tmdn
軉	tmdm
車	lghh
軋	lnn
軌	lvn
軍	plj
軎	lkf
軏	lgqn
軐	lnfh
軑	ldy
軒	lfh
軓	lmyy
軔	lvyy
軕	lmh
軖	lgg
軗	lmcy
軘	lgbn
軙	lhcy
軚	ldyy
軛	ldbn
軜	lmwy
軝	lqan
軞	ltfn
軟	lqwy
軠	ltfg
軡	lwyn
転	lfcy
軣	liu
軤	ltuh
軥	lqkg
軦	lkqn
軧	lqay
軨	lwyc
軩	lckg
軪	lxln
軫	lwet
軬	cdlj
軭	lagg
軮	lmdy
軯	lguh
軰	uxlj
軱	lrcy
軲	ldg
軳	lqnn
軴	lygg
軵	lwfy
軶	lynn
軷	ldcy
軸	lmg
軹	lkwy
軺	lvkg
軻	lskg
軼	lrwy
軽	lcfg
軾	laag
軿	luah
輀	ldmj
輁	lawy
輂	awlj
較	luqy
輄	liqn
輅	ltkg
輆	lynw
輇	lwgg
輈	ltey
載	falk
輊	lgcf
輋	mdlj
輌	lgmm
輍	lwwk
輎	lieg
輏	lsgg
輐	lpfq
輑	lvtk
輒	lbnn
輓	lqkq
輔	lgey
輕	lgva
輖	lmfk
輗	lvqn
輘	lfwt
輙	lbcy
輚	laat
輛	lgmy
輜	lvlg
輝	iqpl
輞	lmun
輟	lccc
輠	ljsy
輡	lqvg
輢	ldsk
輣	leeg
輤	lgeg
輥	ljxx
輦	fwfl
輧	ltff
輨	lpnn
輩	djdl
輪	lwga
輫	ldjd
輬	lyiy
輭	ldmd
輮	lcbs
輯	lkbg
輰	ljgr
輱	ldgt
輲	lmdj
輳	ldwd
輴	lrfh
輵	ljqn
輶	lusg
輷	lqyg
輸	lwgj
輹	ltjt
輺	lgvl
輻	lgkl
輼	ljlg
輽	lcdl
輾	lnae
輿	wflw
轀	llwl
轁	levg
轂	fpgc
轃	ldwt
轄	lpdk
轅	lfke
轆	lynx
轇	lnwe
轈	lvjs
轉	lgjf
轊	ldhv
轋	llpy
轌	lfvg
轍	lyct
轎	ltdk
轏	lnbb
轐	logy
轑	ldui
轒	lfam
轓	ltol
轔	loqh
轕	lajn
轖	lfwk
轗	ldgn
轘	llge
轙	lugt
轚	lbml
轛	logf
轜	lfdj
轝	wfgl
轞	lahl
轟	lllj
轠	llll
轡	xlxk
轢	lxrs
轣	ldth
轤	lhal
轥	lauy
车	lgnh
轧	lnn
轨	lvn
轩	lfh
轪	ldy
轫	lvyy
转	lfny
轭	ldbn
轮	lwxn
软	lqwy
轰	lccu
轱	ldg
轲	lskg
轳	lhnt
轴	lmg
轵	lkwy
轶	lrwy
轷	ltuh
轸	lwet
轹	lqiy
轺	lvkg
轻	lcag
轼	laag
载	falk
轾	lgcf
轿	ltdj
辀	ltey
辁	lwgg
辂	ltkg
较	luqy
辄	lbnn
辅	lgey
辆	lgmw
辇	fwfl
辈	djdl
辉	iqpl
辊	ljxx
辋	lmun
辌	lyiy
辍	lccc
辎	lvlg
辏	ldwd
辐	lgkl
辑	lkbg
辒	ljlg
输	lwgj
辔	xlxk
辕	lfke
辖	lpdk
辗	lnae
辘	lynx
辙	lyct
辚	loqh
辛	uygh
辜	duj
辝	ckuh
辞	tduh
辟	nkuh
辠	thuj
辡	uuh
辢	gkiu
辣	ugki
辤	epcu
辥	btwu
辦	uluh
辧	uvuh
辨	uytu
辩	uyuh
辪	hwnu
辫	uxuh
辬	uyuh
辭	ecmu
辮	uxiu
辯	uyuh
辰	dfei
辱	dfef
農	made
辳	ssde
辴	kkje
辵	ehu
辶	pyny
辷	gpd
辸	epv
边	lpv
辺	vpv
辻	fpk
込	typi
辽	bpk
达	dpi
辿	mpk
迀	fpk
迁	tfpk
迂	gfpk
迃	fnpv
迄	tnpv
迅	nfpk
迆	bpv
过	fpi
迈	dnpv
迉	npe
迊	gmhp
迋	gpd
迌	epd
迍	gbnp
迎	pyfg
迏	dypi
运	fcpi
近	rpk
迒	ympv
迓	ahtp
返	rcpi
迕	tfpk
迖	dpi
迗	gdpi
还	gipi
这	ypi
迚	khpk
进	fjpk
远	fqpv
违	fnhp
连	lpk
迟	nypi
迠	hkpd
迡	nxpv
迢	vkpd
迣	anpv
迤	tbpv
迥	mkpd
迦	lkpd
迧	jhpk
迨	ckpd
迩	qipi
迪	mpd
迫	rpd
迬	ygpd
迭	rwpi
迮	thfp
迯	qhpi
述	sypi
迱	pxpv
迲	fcpi
迳	capd
迴	lkpd
迵	mgkp
迶	depd
迷	opi
迸	uapk
迹	yopi
迺	spd
迻	qqpi
迼	fkpd
追	wnnp
迾	gqjp
迿	qjpd
退	vepi
送	udpi
适	tdpd
逃	iqpv
逄	tahp
逅	rgkp
逆	ubtp
逇	fbpv
逈	tmkp
选	tfqp
逊	bipi
逋	gehp
逌	hlnp
逍	iepd
逎	sgpd
透	tepv
逐	epi
逑	fiyp
递	uxhp
逓	rfmp
途	wtpi
逕	gvap
逖	qtop
逗	gkup
逘	ctdp
這	ypd
通	cepk
逛	qtgp
逜	gkpd
逝	rrpk
逞	kgpd
速	gkip
造	tfkp
逡	cwtp
逢	tdhp
連	lpk
逤	iitp
逥	mjdp
逦	gmyp
逧	wwkp
逨	swwp
逩	dfap
逪	ajpd
逫	cccp
逬	tftp
逭	pnhp
逮	vipi
逯	vipi
逰	rtbp
週	mfkp
進	wypd
逳	ycep
逴	hjpk
逵	fwfp
逶	tvpd
逷	jqrp
逸	qkqp
逹	fufp
逺	fnep
逻	lqpi
逼	gklp
逽	adkp
逾	wgep
逿	jgqp
遀	daep
遁	rfhp
遂	uepi
遃	utep
遄	mdmp
遅	nudp
遆	upmp
遇	jmhp
遈	jghp
遉	hmpi
遊	ytbp
運	plpk
遌	kkfp
遍	ynmp
過	mnmp
遏	jqwp
遐	nhfp
遑	rgpd
遒	usgp
道	uthp
達	fudp
違	nhkp
遖	fmup
遗	khgp
遘	fjgp
遙	qrmp
遚	vhcp
遛	qyvp
遜	btxp
遝	lipi
遞	rhap
遟	nupk
遠	fkep
遡	ubtp
遢	jnpd
遣	khgp
遤	cpi
遥	ermp
遦	xfmp
遧	ujpk
遨	gqtp
適	umdp
遪	cccp
遫	gkip
遬	gkip
遭	gmap
遮	yaop
遯	eepi
遰	aqpp
遱	lvpd
遲	nirp
遳	awwp
遴	oqap
遵	usgp
遶	fffp
遷	sdnp
選	nnap
遹	cbtp
遺	khgp
遻	kkup
遼	dujp
遽	haep
遾	tawp
避	nkup
邀	rytp
邁	ajmp
邂	qevp
邃	pwup
還	lgkp
邅	ylkp
邆	wgkp
邇	gwmp
邈	eerp
邉	thpp
邊	thpp
邋	vlqp
邌	tqtp
邍	tlvp
邎	qytp
邏	lxwp
邐	gmyp
邑	kcb
邒	sbh
邓	cbh
邔	nbh
邕	vkcb
邖	mbh
邗	fbh
邘	gfbh
邙	ynbh
邚	vbh
邛	abh
邜	qbh
邝	ybh
邞	fwbh
邟	ymbh
邠	wvbh
邡	ybh
邢	gabh
那	vfbh
邤	rbh
邥	pqbh
邦	dtbh
邧	fqbh
邨	gbnb
邩	obh
邪	ahtb
邫	dtkc
邬	qngb
邭	qkbh
邮	mbh
邯	afbh
邰	ckbh
邱	rgbh
邲	ntbh
邳	gigb
邴	gmwb
邵	vkbh
邶	uxbh
邷	gnyb
邸	qayb
邹	qvbh
邺	ogbh
邻	wycb
邼	agbh
邽	ffbh
邾	ribh
邿	ffbh
郀	dfnb
郁	debh
郂	yntb
郃	wgkb
郄	qdcb
郅	gcfb
郆	fkbh
郇	qjbh
郈	rgkb
郉	ftfb
郊	uqbh
郋	thbh
郌	ffkc
郍	tebh
郎	yvcb
郏	guwb
郐	wfcb
郑	udbh
郒	yvcc
郓	plbh
郔	thpb
郕	dnnb
郖	gkub
郗	qdmb
郘	kkbh
郙	gehb
郚	gkbh
郛	ebbh
郜	tfkb
郝	fobh
郞	yveb
郟	dwwb
郠	gjqb
郡	vtkb
郢	kgbh
郣	fpbb
郤	wwkb
郥	mbh
郦	gmyb
郧	kmbh
部	ukbh
郩	qdeb
郪	gvhb
郫	rtfb
郬	gebh
郭	ybbh
郮	mfkb
郯	oobh
郰	bcbh
郱	uabh
郲	swwb
郳	vqbh
郴	ssbh
郵	tgab
郶	ukkc
郷	xtvb
郸	ujfb
郹	hdbh
郺	qqvc
郻	hnvb
郼	nhkb
都	ftjb
郾	ajvb
郿	nhbh
鄀	adkb
鄁	uxeb
鄂	kkfb
鄃	wgeb
鄄	sfbh
鄅	tkmb
鄆	plbh
鄇	wntb
鄈	wgdb
鄉	xtyb
鄊	xtbb
鄋	vhcb
鄌	yvhb
鄍	pjub
鄎	thnb
鄏	dfeb
鄐	yxlb
鄑	gogb
鄒	qbtb
鄓	ahnl
鄔	wngb
鄕	xtrb
鄖	kmbh
鄗	ymkb
鄘	yveb
鄙	kflb
鄚	ajdb
鄛	vjsb
鄜	ynjb
鄝	nweb
鄞	akgb
鄟	gjhb
鄠	ffnb
鄡	wvgb
鄢	ghgb
鄣	ujbh
鄤	jlcb
鄥	wvgb
鄦	rlgb
鄧	wgkb
鄨	umic
鄩	vakb
鄪	xjmb
鄫	uljb
鄬	etnb
鄭	usgb
鄮	qyvb
鄯	udub
鄰	oqab
鄱	tolb
鄲	kkjb
鄳	xbh
鄴	ogub
鄵	kkkb
鄶	wglb
鄷	magb
鄸	alpb
鄹	bctb
鄺	yamb
鄻	fwfb
鄼	fwfb
鄽	yjfb
鄾	depb
鄿	akkb
酀	aukb
酁	qkxb
酂	tfqb
酃	fkkb
酄	akkb
酅	mwyb
酆	dhdb
酇	tfqb
酈	gmyb
酉	sgd
酊	sgsh
酋	usgf
酌	sgqy
配	sgnn
酎	sgfy
酏	sgbn
酐	sgfh
酑	sggf
酒	isgg
酓	wyng
酔	sgvf
酕	sgtn
酖	sgpq
酗	sgqb
酘	sgmc
酙	sguf
酚	sgwv
酛	sgfq
酜	sgfw
酝	sgfc
酞	sgdy
酟	sghk
酠	sgsk
酡	sgpx
酢	sgtf
酣	sgaf
酤	sgdg
酥	sgty
酦	sgny
酧	sgpf
酨	fasg
酩	sgqk
酪	sgtk
酫	sgwg
酬	sgyh
酭	sgde
酮	sgmk
酯	sgxj
酰	sgtq
酱	uqsg
酲	sgkg
酳	sgxe
酴	sgwt
酵	sgfb
酶	sgtu
酷	sgtk
酸	sgct
酹	sgef
酺	sggy
酻	sgeb
酼	sgyq
酽	sggd
酾	sggy
酿	pfiu
醀	sgwy
醁	sgvi
醂	sgss
醃	sgdn
醄	sgqm
醅	sguk
醆	sgaa
醇	sgyb
醈	sgoo
醉	sgyf
醊	sgcc
醋	sgaj
醌	sgjx
醍	sgjh
醎	sgdt
醏	sgfj
醐	sgde
醑	sgne
醒	sgjg
醓	sgpl
醔	tosg
醕	sgyj
醖	sgjl
醗	sgwq
醘	sgfl
醙	sgvc
醚	sgop
醛	sgag
醜	sgrc
醝	sgua
醞	sgll
醟	oopg
醠	sgml
醡	sgpf
醢	sgdl
醣	sgyk
醤	uefg
醥	sgsi
醦	sgce
醧	sgak
醨	sgyc
醩	sggj
醪	sgne
醫	atdg
醬	nhdg
醭	sgoy
醮	sgwo
醯	sgyl
醰	sgsj
醱	sgwc
醲	sgme
醳	sglf
醴	sgmu
醵	sghe
醶	sgww
醷	sgun
醸	sgue
醹	sgfj
醺	sgto
醻	sgff
醼	sgao
醽	sgfk
醾	sgyo
醿	sgyi
釀	sgye
釁	wfmv
釂	sgef
釃	sggx
釄	sgyd
釅	sgkt
釆	toi
采	esu
釈	tony
釉	tomg
释	toch
釋	tolf
里	jfd
重	tgjf
野	jfcb
量	jgjf
釐	fitf
金	qqqq
釒	qtyg
釓	qnn
釔	qnn
釕	qbh
釖	qvn
釗	qjh
釘	qsh
釙	qhy
釚	qvn
釛	qln
釜	wqfu
針	qfh
釞	qtyy
釟	qwy
釠	qmn
釡	wqf
釢	qen
釣	qqyy
釤	qet
釥	qiy
釦	qkg
釧	qkh
釨	qbg
釩	qmyy
釪	qgfh
釫	qfnn
釬	qfh
釭	qag
釮	qftt
釯	qynn
釰	qvyy
釱	qdy
釲	qnn
釳	qtnn
釴	qay
釵	qcyy
釶	qbn
釷	qfg
釸	qqy
釹	qvg
釺	qtfh
釻	qvyy
釼	qvyy
釽	qrhy
釾	qaht
釿	qrh
鈀	qcn
鈁	qyn
鈂	qpqn
鈃	qgah
鈄	qufh
鈅	qeg
鈆	qwcy
鈇	qfwy
鈈	qgiy
鈉	qmwy
鈊	qny
鈋	qwxn
鈌	hhgg
鈍	qgbn
鈎	qqcy
鈏	qxhh
鈐	qwyn
鈑	qrcy
鈒	qeyy
鈓	qtfg
鈔	qitt
鈕	qnfg
鈖	qwvn
鈗	qcqn
鈘	qfcy
鈙	qhcy
鈚	qxxn
鈛	qat
鈜	qdcy
鈝	qrhh
鈞	qqug
鈟	qxhh
鈠	qmcy
鈡	qkhh
鈢	qsy
鈣	qghn
鈤	qjg
鈥	qoy
鈦	qdyy
鈧	qymn
鈨	qfqn
鈩	qynt
鈪	qdbn
鈫	qyy
鈬	qnyy
鈭	hxqf
鈮	qnxn
鈯	qbmh
鈰	qymh
鈱	qnan
鈲	qrcy
鈳	qskg
鈴	qwyc
鈵	qgmw
鈶	qckg
鈷	qdg
鈸	qdcy
鈹	qhcy
鈺	qgyy
鈻	qnhn
鈼	qthf
鈽	qdmh
鈾	qmg
鈿	qlg
鉀	qlh
鉁	qwet
鉂	qkqy
鉃	qtdy
鉄	qrwy
鉅	qang
鉆	qhkg
鉇	qtbn
鉈	qpxn
鉉	qyxy
鉊	qvkg
鉋	qqnn
鉌	qty
鉍	qntt
鉎	qtgg
鉏	qegg
鉐	qdg
鉑	qrg
鉒	qygg
鉓	qtmh
鉔	qamh
鉕	qakg
鉖	qtuy
鉗	qafg
鉘	qxjh
鉙	qkwy
鉚	qqtb
鉛	qmkg
鉜	qwfy
鉝	qug
鉞	qant
鉟	qgig
鉠	qmdy
鉡	qufh
鉢	qsgg
鉣	qfcy
鉤	qqkg
鉥	qsyy
鉦	qghg
鉧	qxgu
鉨	qqiy
鉩	qwiy
鉪	qann
鉫	qlkg
鉬	qhg
鉭	qjgg
鉮	qjhh
鉯	qnyw
鉰	qngk
鉱	qycy
鉲	qhhy
鉳	quxn
鉴	jtyq
鉵	qjy
鉶	qgaj
鉷	qawy
鉸	quqy
鉹	qqqy
鉺	qbg
鉻	qtkg
鉼	quah
鉽	qaag
鉾	qcrh
鉿	qwgk
銀	qvey
銁	qqjg
銂	qyth
銃	qycq
銄	qtmk
銅	qmgk
銆	qdjg
銇	qdiy
銈	qffg
銉	qvfh
銊	qdgt
銋	qwtf
銌	qdhb
銍	qgcf
銎	amyq
銏	qmmg
銐	gqjq
銑	qtfq
銒	qftf
銓	qwgg
銔	qgif
銕	qgxw
銖	qriy
銗	qrgk
銘	qqkg
銙	qdfn
銚	qiqn
銛	qtdg
銜	tqfh
銝	qwsy
銞	qjqf
銟	qmmh
銠	qftx
銡	qfkg
銢	qfiy
銣	qvkg
銤	qoy
銥	qyey
銦	qldy
銧	qiqn
銨	qpvg
銩	qtfc
銪	qdeg
銫	qqcn
銬	qftn
銭	qdxy
銮	yoqf
銯	qxiy
銰	qaqy
銱	qkmh
銲	qjfh
銳	qwkq
銴	rrqf
銵	qtmt
銶	qfiy
銷	qieg
銸	qbnn
銹	qten
銺	nhdq
銻	quxt
銼	qwwf
銽	qqak
銾	qaiy
銿	qceh
鋀	qgku
鋁	qkkg
鋂	qtxu
鋃	qyve
鋄	qgoc
鋅	quh
鋆	fquq
鋇	qmy
鋈	itdq
鋉	qgki
鋊	qwwk
鋋	qthp
鋌	qtfp
鋍	qfpb
鋎	qpfq
鋏	qdww
鋐	qpdc
鋑	qcwt
鋒	qtdh
鋓	qtjh
鋔	qqkq
鋕	qfny
鋖	qevg
鋗	qkeg
鋘	qkgd
鋙	qgkg
鋚	whtq
鋛	qkkh
鋜	qkhy
鋝	qefy
鋞	qgva
鋟	qvpc
鋠	qdfe
鋡	qwyk
鋢	qebg
鋣	qahb
鋤	qegl
鋥	qkgg
鋦	qnnk
鋧	qhqn
鋨	qtrt
鋩	qayn
鋪	qgey
鋫	tjqf
鋬	rrcq
鋭	qukq
鋮	qdnt
鋯	qtfk
鋰	qjfg
鋱	qany
鋲	qrgw
鋳	qdtf
鋴	qdqn
鋵	qtmn
鋶	qycq
鋷	qbcy
鋸	qndg
鋹	qdey
鋺	qpqb
鋻	ahnq
鋼	qmum
鋽	qhjh
鋾	qqrm
鋿	qimk
錀	qwga
錁	qjsy
錂	qfwt
錃	ihcq
錄	qxgi
錅	tqtq
錆	qgeg
錇	qukg
錈	qudb
錉	qqaj
錊	qywf
錋	qeeg
錌	qmdf
錍	qrtf
錎	qqvg
錏	qgfg
錐	qwyg
錑	qynd
錒	qbsk
錓	qudn
錔	qijg
錕	qjxx
錖	hicq
錗	qtvg
錘	qtgf
錙	qvlg
錚	qqvh
錛	qdfa
錜	qwyn
錝	qpfi
錞	qybg
錟	qooy
錠	qpgh
錡	qdsk
錢	qaat
錣	qccc
錤	qadw
錥	qyce
錦	qrmh
錧	qpnn
錨	qalg
錩	qjjg
錪	qmaw
錫	qjqr
錬	qgji
錭	qmfk
錮	qldg
錯	qajg
錰	qsoy
錱	qggf
録	qviy
錳	qblg
錴	qfwf
錵	qawx
錶	qgey
錷	qlnn
錸	qsww
錹	qheg
錺	qayn
錻	qgah
錼	qdfi
錽	qgot
錾	lrqf
錿	qham
鍀	qjgf
鍁	qrqw
鍂	qqg
鍃	qqrn
鍄	qyiy
鍅	qifc
鍆	qug
鍇	qxxr
鍈	qamd
鍉	qjgh
鍊	qgli
鍋	qmnk
鍌	itfq
鍍	qyac
鍎	qrfh
鍏	qnhh
鍐	qqbt
鍑	qtjt
鍒	qcbs
鍓	qkbg
鍔	qkkn
鍕	qplh
鍖	qadn
鍗	quph
鍘	qmjh
鍙	iawq
鍚	qjgr
鍛	qwdc
鍜	qnhc
鍝	qjmy
鍞	qhmy
鍟	qjtg
鍠	qrgg
鍡	qlge
鍢	qgkl
鍣	qavk
鍤	qtfv
鍥	qdhd
鍦	qytb
鍧	qqyg
鍨	qwgd
鍩	qadk
鍪	cbtq
鍫	toqf
鍬	qtoy
鍭	qwnd
鍮	qwgj
鍯	qqrn
鍰	qefc
鍱	qans
鍲	qnaj
鍳	ahnq
鍴	qmdj
鍵	qvfp
鍶	qlny
鍷	qdff
鍸	qdeg
鍹	qpgg
鍺	qftj
鍻	qjqn
鍼	qdgt
鍽	qyna
鍾	qtgf
鍿	qgvl
鎀	qwhe
鎁	qbbh
鎂	qugd
鎃	qire
鎄	qyey
鎅	qlwj
鎆	quej
鎇	qnhg
鎈	quda
鎉	qjng
鎊	qupy
鎋	qpdk
鎌	quvo
鎍	qfpi
鎎	qrno
鎏	iycq
鎐	qerm
鎑	qfcl
鎒	qdff
鎓	qwcn
鎔	qpwk
鎕	qyvk
鎖	qimy
鎗	qwyk
鎘	qgkh
鎙	qube
鎚	qwnp
鎛	qgef
鎜	temq
鎝	qawk
鎞	qtlx
鎟	qccs
鎠	qlgh
鎡	quxx
鎢	qwno
鎣	oopq
鎤	qjiq
鎥	whtq
鎦	qqyl
鎧	qmgu
鎨	qwyf
鎩	qqsc
鎪	qvhc
鎫	qtmt
鎬	qymk
鎭	qxhw
鎮	qfhw
鎯	qyvb
鎰	quwl
鎱	qfke
鎲	qipq
鎳	qths
鎴	qthn
鎵	qpey
鎶	qskk
鎷	qcy
鎸	qwye
鎹	qudp
鎺	qpyg
鎻	qvmy
鎼	qhar
鎽	qmth
鎾	qjlg
鎿	qwgr
鏀	qhlo
鏁	qvjs
鏂	qakk
鏃	qytd
鏄	qgjf
鏅	qwhe
鏆	qxfm
鏇	qyth
鏈	qlpy
鏉	qgkw
鏊	gqtq
鏋	qamy
鏌	qajd
鏍	qlxi
鏎	qjaf
鏏	qdhv
鏐	qnwe
鏑	qumd
鏒	qcce
鏓	qtln
鏔	qpgw
鏕	qynx
鏖	ynjq
鏗	qahf
鏘	qnhf
鏙	qmwy
鏚	qdht
鏛	qiph
鏜	qipf
鏝	qjlc
鏞	qyvh
鏟	qutg
鏠	qtdp
鏡	qujq
鏢	qsfi
鏣	qyao
鏤	qlvg
鏥	qpwj
鏦	qtwh
鏧	fnmq
鏨	lrqf
鏩	qlrh
鏪	qgmj
鏫	qtjs
鏬	qhah
鏭	qton
鏮	qyvi
鏯	qdqq
鏰	qmee
鏱	qujh
鏲	qyxh
鏳	qulj
鏴	qkhk
鏵	qagf
鏶	qwys
鏷	qogy
鏸	qgjn
鏹	qxkj
鏺	qwxc
鏻	qoqh
鏼	qtgi
鏽	qvfj
鏾	qaet
鏿	qips
鐀	qkhm
鐁	qadr
鐂	qgal
鐃	qffq
鐄	qamw
鐅	umiq
鐆	bueq
鐇	qtol
鐈	qtdk
鐉	qnnw
鐊	qbjr
鐋	qijr
鐌	qqje
鐍	qcbk
鐎	qwyo
鐏	qusf
鐐	qdui
鐑	qxfk
鐒	qool
鐓	qybt
鐔	qsjh
鐕	qaqj
鐖	qxxt
鐗	queg
鐘	qujf
鐙	qwgu
鐚	qgfn
鐛	qjyi
鐜	ybtq
鐝	qduw
鐞	qvaf
鐟	qfwj
鐠	quoj
鐡	qfau
鐢	sqqq
鐣	qipr
鐤	qhnn
鐥	qudk
鐦	quga
鐧	qujg
鐨	qxjm
鐩	quep
鐪	qhal
鐫	qwym
鐬	qhdt
鐭	qtmd
鐮	qyuo
鐯	qafj
鐰	qkks
鐱	qwgw
鐲	qlqj
鐳	qflg
鐴	qnku
鐵	qfag
鐶	qlge
鐷	qaas
鐸	qlff
鐹	qmnp
鐺	qipl
鐻	qhae
鐼	qfam
鐽	qfup
鐾	nkuq
鐿	qujn
鑀	qept
鑁	qqot
鑂	qtgo
鑃	qnwy
鑄	qfnf
鑅	qoos
鑆	qogf
鑇	qyjg
鑈	qgwq
鑉	qafl
鑊	qawc
鑋	lgvq
鑌	qpgm
鑍	mmqf
鑎	qakm
鑏	qpns
鑐	qfdj
鑑	qahl
鑒	ahnq
鑓	qkhp
鑔	qpwi
鑕	qrrm
鑖	qalt
鑗	qtqi
鑘	qlll
鑙	qtdj
鑚	qfwm
鑛	qyaw
鑜	qipm
鑝	qatp
鑞	qvln
鑟	qflm
鑠	qxrs
鑡	qhbh
鑢	qhan
鑣	qyno
鑤	qjai
鑥	qqoj
鑦	qahm
鑧	qpay
鑨	qued
鑩	qgkk
鑪	qhal
鑫	qqqf
鑬	qahq
鑭	qugi
鑮	qaif
鑯	qwwg
鑰	qwga
鑱	qqky
鑲	qyke
鑳	qpfh
鑴	qmwk
鑵	qaky
鑶	qadt
鑷	qbbb
鑸	qllf
鑹	qpwn
鑺	qhhy
鑻	qsqr
鑼	qlxy
鑽	qtfm
鑾	xyxq
鑿	oguq
钀	qhad
钁	qhhc
钂	qipo
钃	qnij
钄	qaui
钅	qtgn
钆	qnn
钇	qnn
针	qfh
钉	qsh
钊	qjh
钋	qhy
钌	qbh
钍	qfg
钎	qtfh
钏	qkh
钐	qet
钑	qeyy
钒	qmyy
钓	qqyy
钔	qun
钕	qvg
钖	qnrt
钗	qcyy
钘	qgah
钙	qghn
钚	qgiy
钛	qdyy
钜	qang
钝	qgbn
钞	qitt
钟	qkhh
钠	qmwy
钡	qmy
钢	qmqy
钣	qrcy
钤	qwyn
钥	qeg
钦	qqwy
钧	qqug
钨	qqng
钩	qqcy
钪	qymn
钫	qyn
钬	qoy
钭	qufh
钮	qnfg
钯	qcn
钰	qgyy
钱	qgt
钲	qghg
钳	qafg
钴	qdg
钵	qsgg
钶	qskg
钷	qakg
钸	qdmh
钹	qdcy
钺	qant
钻	qhkg
钼	qhg
钽	qjgg
钾	qlh
钿	qlg
铀	qmg
铁	qrwy
铂	qrg
铃	qwyc
铄	qqiy
铅	qmkg
铆	qqtb
铇	qqnn
铈	qymh
铉	qyxy
铊	qpxn
铋	qntt
铌	qnxn
铍	qhcy
铎	qcfh
铏	qgaj
铐	qftn
铑	qftx
铒	qbg
铓	qayn
铔	qgog
铕	qdeg
铖	qdnt
铗	qguw
铘	qahb
铙	qatq
铚	qgcf
铛	qivg
铜	qmgk
铝	qkkg
铞	qkmh
铟	qldy
铠	qmnn
铡	qmjh
铢	qriy
铣	qtfq
铤	qtfp
铥	qtfc
铦	qtdg
铧	qwxf
铨	qwgg
铩	qqsy
铪	qwgk
铫	qiqn
铬	qtkg
铭	qqkg
铮	qqvh
铯	qqcn
铰	quqy
铱	qyey
铲	qutt
铳	qycq
铴	qinr
铵	qpvg
银	qvey
铷	qvkg
铸	qdtf
铹	qapl
铺	qgey
铻	qgkg
铼	qgoy
铽	qany
链	qlpy
铿	qjcf
销	qieg
锁	qimy
锂	qjfg
锃	qkgg
锄	qegl
锅	qkmw
锆	qtfk
锇	qtrt
锈	qten
锉	qwwf
锊	qefy
锋	qtdh
锌	quh
锍	qycq
锎	quga
锏	qujg
锐	qukq
锑	quxt
锒	qyve
锓	qvpc
锔	qnnk
锕	qbsk
锖	qgeg
锗	qftj
锘	qadk
错	qajg
锚	qalg
锛	qdfa
锜	qdsk
锝	qjgf
锞	qjsy
锟	qjxx
锠	qjjg
锡	qjqr
锢	qldg
锣	qlqy
锤	qtgf
锥	qwyg
锦	qrmh
锧	qrfm
锨	qrqw
锩	qudb
锪	qqrn
锫	qukg
锬	qooy
锭	qpgh
键	qvfp
锯	qndg
锰	qblg
锱	qvlg
锲	qdhd
锳	qamd
锴	qxxr
锵	quqf
锶	qlny
锷	qkkn
锸	qtfv
锹	qtoy
锺	qtgf
锻	qwdc
锼	qvhc
锽	qrgg
锾	qefc
锿	qyey
镀	qyac
镁	qugd
镂	qovg
镃	quxx
镄	qxjm
镅	qnhg
镆	qajd
镇	qfhw
镈	qgef
镉	qgkh
镊	qbcc
镋	qipq
镌	qwye
镍	qths
镎	qwgr
镏	qqyl
镐	qymk
镑	qupy
镒	quwl
镓	qpey
镔	qprw
镕	qpwk
镖	qsfi
镗	qipf
镘	qjlc
镙	ffff
镚	qmee
镛	qyvh
镜	qujq
镝	qumd
镞	qytd
镟	qyth
镠	qnwe
镡	qsjh
镢	qduw
镣	qdui
镤	qogy
镥	qqgj
镦	qybt
镧	qugi
镨	quoj
镩	qpwh
镪	qxkj
镫	qwgu
镬	qawc
镭	qflg
镮	qlge
镯	qlqj
镰	qyuo
镱	qujn
镲	qpwi
镳	qyno
镴	qvln
镵	qqky
镶	qyke
長	deu
镸	dghy
镹	dqyy
镺	dtdy
镻	drwy
镼	dnbm
镽	ddui
镾	dgwq
长	tayi
門	uhng
閁	ute
閂	ugd
閃	uwi
閄	uwy
閅	usk
閆	udd
閇	ughi
閈	ufk
閉	ufte
閊	umk
開	ugak
閌	uymv
閍	uyv
閎	udci
閏	ugd
閐	utfn
閑	usi
閒	ued
間	ujd
閔	uyi
閕	uaht
閖	uii
閗	uufk
閘	ulk
閙	uymh
閚	uud
閛	uguh
閜	uskd
閝	uwyc
閞	ucak
閟	unte
閠	ugyi
閡	uynw
関	uudi
閣	utkd
閤	uwgk
閥	uwae
閦	uwww
閧	uawi
閨	uffd
閩	uji
閪	usd
閫	ulsi
閬	uyve
閭	ukkd
閮	utfp
閯	uiit
閰	uvd
閱	uwkq
閲	uukq
閳	ulk
閴	umi
閵	uwyd
閶	ujjd
閷	qsuw
閸	ugfg
閹	udjn
閺	ujyi
閻	uqvd
閼	uywu
閽	uqaj
閾	uakg
閿	uepc
闀	uawn
闁	uud
闂	uudb
闃	uhdi
闄	usvd
闅	uhhc
闆	ukkk
闇	uujd
闈	unhh
闉	usfd
闊	uitd
闋	uwgd
闌	ugli
闍	uftj
闎	urii
闏	umtj
闐	ufhw
闑	uths
闒	ujnd
闓	umgu
闔	ufcl
闕	uubw
闖	uci
闗	uxxo
闘	ugkf
闙	uynk
闚	ufwq
闛	uipf
關	uxxg
闝	umti
闞	unbt
闟	uwgn
闠	ukhm
闡	ukkf
闢	unku
闣	uipl
闤	ulge
闥	ufup
闦	umau
闧	ufkp
门	uyhn
闩	ugd
闪	uwi
闫	udd
闬	ufk
闭	ufte
问	ukd
闯	ucd
闰	ugd
闱	ufnh
闲	usi
闳	udci
间	ujd
闵	uyi
闶	uymv
闷	uni
闸	ulk
闹	uymh
闺	uffd
闻	ubd
闼	udpi
闽	uji
闾	ukkd
闿	umnv
阀	uwae
阁	utkd
阂	uynw
阃	ulsi
阄	uqjn
阅	uukq
阆	uyve
阇	uftj
阈	uakg
阉	udjn
阊	ujjd
阋	uvqv
阌	uepc
阍	uqaj
阎	uqvd
阏	uywu
阐	uujf
阑	ugli
阒	uhdi
阓	ukhm
阔	uitd
阕	uwgd
阖	ufcl
阗	ufhw
阘	ujnd
阙	uubw
阚	unbt
阛	ulge
阜	wnnf
阝	bnh
阞	bln
队	bwy
阠	bnfh
阡	btfh
阢	bgqn
阣	btnn
阤	bbn
阥	biy
阦	boy
阧	bufh
阨	bdbn
阩	btah
阪	brcy
阫	bgiy
阬	bymn
阭	bcqn
阮	bfqn
阯	bhg
阰	bxxn
阱	bfjh
防	byn
阳	bjg
阴	beg
阵	blh
阶	bwjh
阷	bghg
阸	bynn
阹	bfcy
阺	bqay
阻	begg
阼	bthf
阽	bhkg
阾	bwyc
阿	bskg
陀	bpxn
陁	btbn
陂	bhcy
陃	bgmw
附	bwfy
际	bfiy
陆	bfmh
陇	bdxn
陈	baiy
陉	bcag
陊	bqqy
陋	bgmn
陌	bdjg
降	btah
陎	briy
陏	bdeg
限	bvey
陑	bdmj
陒	bqdb
陓	bdfn
陔	bynw
陕	bguw
陖	bcwt
陗	bieg
陘	bgva
陙	bdfe
陚	bgah
陛	bxxf
陜	bdww
陝	bdty
陞	btaf
陟	bhit
陠	bgey
陡	bfhy
院	bpfq
陣	blh
除	bwty
陥	bqhj
陦	bdtf
陧	bjfg
陨	bkmy
险	bwgi
陪	bukg
陫	bdjd
陬	bbcy
陭	bdsk
陮	bwyg
陯	bwga
陰	bwyc
陱	bqoy
陲	btgf
陳	bgji
陴	brtf
陵	bfwt
陶	bqrm
陷	bqvg
陸	bfwf
陹	btaj
険	bwgw
陻	bsfg
陼	bftj
陽	bjgr
陾	bdmd
陿	badw
隀	btgf
隁	bajv
隂	bwdy
隃	bwgj
隄	bjgh
隅	bjmy
隆	btgg
隇	bdgt
隈	blge
隉	bvag
隊	buey
隋	bdae
隌	bujg
隍	brgg
階	bxxr
随	bdep
隐	bqvn
隑	bmgu
隒	buvo
隓	bdaa
隔	bgkh
隕	bkmy
隖	bwno
隗	brqc
隘	buwl
隙	biji
隚	bipf
際	bwfi
障	bujh
隝	bwvo
隞	bgqt
隟	bvjs
隠	bevn
隡	butg
隢	bffq
隣	boqh
隤	bkhm
隥	bwgu
隦	bnku
隧	buep
隨	bdap
隩	btmd
險	bwgw
隫	bfam
隬	bgwq
隭	bfdj
隮	byjg
隯	bfnf
隰	bjxo
隱	bean
隲	bitc
隳	bdan
隴	bued
隵	bhaa
隶	vii
隷	ffii
隸	sfii
隹	wyg
隺	pwyd
隻	wycu
隼	wyfj
隽	wyeb
难	cwyg
隿	awyg
雀	iwyf
雁	dwwy
雂	wyny
雃	gawy
雄	dcwy
雅	ahty
集	wysu
雇	ynwy
雈	gjgy
雉	tdwy
雊	qkwy
雋	wymm
雌	hxwy
雍	yxty
雎	egwy
雏	qvwy
雐	hawy
雑	vswy
雒	tkwy
雓	wtwy
雔	wywy
雕	mfky
雖	kjwy
雗	fjwy
雘	myac
雙	wywc
雚	akky
雛	qbty
雜	ywwy
雝	vkcy
雞	exdy
雟	btwk
雠	wyyy
雡	nwey
離	ybmy
難	akfy
雤	wfqy
雥	wywy
雦	wywy
雧	wyws
雨	fghy
雩	ffnb
雪	fvf
雫	fghu
雬	fsu
雭	feyu
雮	ftfn
雯	fyu
雰	fwvb
雱	fyb
雲	ffcu
雳	fdlb
雴	fuf
雵	fmdu
零	fwyc
雷	flf
雸	faff
雹	fqnb
雺	fcbt
電	fjnb
雼	fdf
雽	ftuh
雾	ftlb
雿	fiqb
需	fdmj
霁	fyjj
霂	fisu
霃	fipq
霄	fief
霅	fyf
霆	ftfp
震	fdfe
霈	figh
霉	ftxu
霊	ffog
霋	fgvv
霌	fmfk
霍	fwyf
霎	fuvf
霏	fdjd
霐	fixc
霑	fihk
霒	ffcn
霓	fvqb
霔	fiyg
霕	ffcn
霖	fssu
霗	fiwc
霘	fimk
霙	famd
霚	fcbt
霛	fxxx
霜	fshf
霝	fkkk
霞	fnhc
霟	fiaw
霠	fuwn
霡	feyi
霢	fere
霣	fkmu
霤	fqyl
霥	fpge
霦	fsse
霧	fcbl
霨	fnff
霩	fybb
霪	fief
霫	fnrf
霬	flaw
霭	fyjn
霮	fian
霯	fwgu
霰	faet
霱	fcbk
露	fkhk
霳	fbtg
霴	ffci
霵	fkbt
霶	fiuy
霷	fjjr
霸	fafe
霹	fnku
霺	ftmt
霻	fmau
霼	ffco
霽	fyjf
霾	feef
霿	fcbh
靀	fape
靁	flll
靂	fdth
靃	fwyy
靄	fyjn
靅	ffcm
靆	ffcp
靇	fued
靈	fkkw
靉	ffct
靊	fdhu
靋	fidh
靌	fpgm
靍	fwyo
靎	fqwo
靏	fpwo
靐	flfl
靑	gmhg
青	gef
靓	gemq
靔	gern
靕	ghge
靖	ugeg
靗	geiq
靘	geqc
静	geqh
靚	gehq
靛	geph
靜	geeh
靝	gero
非	djdd
靟	djdn
靠	tfkd
靡	yssd
面	dmjd
靣	dlkf
靤	dmjn
靥	dddd
靦	dmjq
靧	dmjm
靨	djed
革	afj
靪	afsh
靫	afcy
靬	affh
靭	afvy
靮	afqy
靯	affg
靰	afgq
靱	afvy
靲	afwn
靳	afrh
靴	afwx
靵	afnf
靶	afcn
靷	afxh
靸	afey
靹	afmw
靺	afgs
靻	afeg
靼	afjg
靽	afuf
靾	afan
靿	afxl
鞀	afvk
鞁	afhc
鞂	afty
鞃	afxc
鞄	afqn
鞅	afmd
鞆	afgw
鞇	afld
鞈	afwk
鞉	afiq
鞊	affk
鞋	afff
鞌	pvaf
鞍	afpv
鞎	afve
鞏	amyf
鞐	afhh
鞑	afdp
鞒	aftj
鞓	afkg
鞔	afqq
鞕	afgq
鞖	afev
鞗	whtf
鞘	afie
鞙	afke
鞚	afpa
鞛	afuk
鞜	afij
鞝	afik
鞞	afrf
鞟	afyb
鞠	afqo
鞡	afru
鞢	afas
鞣	afcs
鞤	ffff
鞥	afwa
鞦	afto
鞧	afug
鞨	afjn
鞩	afij
鞪	cbtf
鞫	afqy
鞬	afvp
鞭	afwq
鞮	afjh
鞯	afab
鞰	afjl
鞱	afev
鞲	afff
鞳	afak
鞴	afae
鞵	afed
鞶	temf
鞷	gkmf
鞸	afjf
鞹	afyb
鞺	afif
鞻	aflv
鞼	afkm
鞽	aftk
鞾	afaf
鞿	afxt
韀	afyo
韁	afgg
韂	afqy
韃	affp
韄	afac
韅	afjo
韆	afsp
韇	affm
韈	afat
韉	afao
韊	afai
韋	nhkh
韌	nhky
韍	nhkc
韎	nhks
韏	udnh
韐	nhkk
韑	iqnh
韒	nhke
韓	fjnh
韔	nhke
韕	nhkb
韖	nhks
韗	nhkl
韘	jjjj
韙	jghh
韚	nhkf
韛	nhke
韜	nhkv
韝	nhkf
韞	nhkl
韟	nhkf
韠	nhkf
韡	nhkf
韢	nhkn
韣	nhkj
韤	nhkt
韥	nhkm
韦	fnhk
韧	fnhy
韨	fnhc
韩	fjfh
韪	jghh
韫	fnhl
韬	fnhv
韭	djdg
韮	adjg
韯	fadg
韰	hqcg
韱	wwag
韲	ydjg
音	ujf
韴	ujgh
韵	ujqu
韶	ujvk
韷	ujbm
韸	ujth
韹	ujrg
韺	ujad
韻	ujkm
韼	ujtp
韽	wynj
韾	fnmj
響	xtyj
頀	ujac
頁	dmu
頂	sdmy
頃	xdmy
頄	vdmy
項	admy
順	kdmy
頇	fdmy
須	edmy
頉	hdmy
頊	gdmy
頋	dbdm
頌	wcdm
頍	fcdm
頎	rdmy
頏	ymdm
預	cbdm
頑	fqdm
頒	wvdm
頓	gbnm
頔	mdmy
頕	hkdm
頖	uddm
頗	hcdm
領	wycm
頙	ghdm
頚	cfdm
頛	didm
頜	wgkm
頝	uqdm
頞	pvdm
頟	tkdm
頠	qdbm
頡	fkdm
頢	tddm
頣	ahnm
頤	ahkm
頥	hahm
頦	yntm
頧	wnnm
頨	ndmy
頩	uadm
頪	odmy
頫	iqdm
頬	guwm
頭	gkum
頮	iadm
頯	qadm
頰	dwwm
頱	efdm
頲	tfpm
頳	fodm
頴	xfim
頵	vtkm
頶	tfkm
頷	wynm
頸	gvam
頹	tqdm
頺	tedm
頻	hidm
頼	gkim
頽	tmdm
頾	edmx
頿	ehxm
顀	wydm
顁	pghm
顂	swwm
顃	oodm
顄	bibm
顅	ynem
顆	jsdm
顇	ywwm
顈	xxim
顉	qdmy
顊	wnnm
顋	lndm
題	jghm
額	ptkm
顎	kkfm
顏	ydem
顐	pldm
顑	dgkm
顒	jmhm
顓	mdmm
顔	utem
顕	jogm
顖	tlqm
顗	mgkm
願	drim
顙	cccm
顚	xhnm
顛	fhwm
顜	fjgm
顝	medm
類	oddm
顟	nwem
顠	sfim
顡	uedm
顢	amhm
顣	dhim
顤	fffm
顥	jyim
顦	wyom
顧	ynwm
顨	dmdj
顩	wgkm
顪	hdgm
顫	ylkm
顬	fdmm
顭	alpm
顮	pgim
顯	jxxm
顰	hidf
顱	halm
顲	ooym
顳	bbbm
顴	akkm
页	dmu
顶	sdmy
顷	xdmy
顸	fdmy
项	admy
顺	kdmy
须	edmy
顼	gdmy
顽	fqdm
顾	dbdm
顿	gbnm
颀	rdmy
颁	wvdm
颂	wcdm
颃	ymdm
预	cbdm
颅	hndm
领	wycm
颇	hcdm
颈	cadm
颉	fkdm
颊	guwm
颋	tfpm
颌	wgkm
颍	xidm
颎	xodm
颏	yntm
颐	ahkm
频	hidm
颒	iadm
颓	tmdm
颔	wynm
颕	xfim
颖	xtdm
颗	jsdm
题	jghm
颙	jmhm
颚	kkfm
颛	mdmm
颜	utem
额	ptkm
颞	bccm
颟	agmm
颠	fhwm
颡	cccm
颢	jyim
颣	oxim
颤	ylkm
颥	fdmm
颦	hidf
颧	akkm
風	mtji
颩	mtje
颪	ghmj
颫	mtjw
颬	mtjt
颭	mtjk
颮	mtjn
颯	umtj
颰	mtjc
颱	mtjk
颲	mtjj
颳	mtjd
颴	mtjh
颵	mtje
颶	mtjw
颷	mtjo
颸	mtjn
颹	mtjh
颺	mtjr
颻	ermj
颼	mtjc
颽	mgkj
颾	mtjj
颿	cmtj
飀	mtjl
飁	nrmj
飂	mtje
飃	mtji
飄	sfij
飅	mtjl
飆	dddj
飇	mtjd
飈	mtjo
飉	mtji
飊	oooj
飋	mtjt
飌	akkj
飍	mtjj
风	mqi
飏	mqnr
飐	mqhk
飑	mqqn
飒	umqy
飓	mqhw
飔	mqln
飕	mqvc
飖	ermq
飗	mqql
飘	sfiq
飙	dddq
飚	mqoo
飛	nuth
飜	tolh
飝	nuth
飞	nui
食	wyve
飠	wyvy
飡	uwye
飢	wpmn
飣	wpsh
飤	wpwy
飥	wpta
飦	wpfh
飧	qwye
飨	xtwe
飩	wpgn
飪	wptf
飫	wptd
飬	udye
飭	wptl
飮	wyvw
飯	wprc
飰	wpyh
飱	gqwe
飲	wpqw
飳	wpyg
飴	wpck
飵	wptf
飶	wpnt
飷	wpeg
飸	kgne
飹	wpqb
飺	hxwe
飻	wpwe
飼	wpnk
飽	wpqn
飾	wpth
飿	wpbm
餀	wpaq
餁	wpwf
餂	wptd
餃	wpuq
餄	wpwk
餅	wpua
餆	wpiq
餇	wpmk
餈	uqwe
餉	wptk
養	udye
餋	udwe
餌	wpbg
餍	ddwe
餎	wptk
餏	wpye
餐	hqce
餑	wpfb
餒	wpev
餓	wptt
餔	wpgy
餕	wpct
餖	wpgu
餗	wpgi
餘	wpwt
餙	wpqh
餚	wpqe
餛	wpjx
餜	wpjs
餝	wpay
餞	wpaa
餟	wpcc
餠	wptf
餡	wpqv
餢	wpuk
餣	wpdn
餤	wpoo
餥	djde
餦	wpde
餧	wptv
館	wppn
餩	wpww
餪	wpdd
餫	wppl
餬	wpde
餭	wprg
餮	gqwe
餯	wpxe
餰	wpth
餱	wpwd
餲	wpjn
餳	wpjr
餴	wpda
餵	wple
餶	wpme
餷	wpsg
餸	wpup
餹	wpyk
餺	wpgf
餻	wpuo
餼	wpro
餽	wprc
餾	wpql
餿	wpvc
饀	wpev
饁	wpfl
饂	wpjl
饃	wpad
饄	wpif
饅	wpjc
饆	wpjf
饇	wpak
饈	wpuf
饉	wpag
饊	wpat
饋	wpkm
饌	wpnw
饍	wpuk
饎	wpfk
饏	nbte
饐	wpfu
饑	wpxt
饒	wpfq
饓	wpis
饔	yxte
饕	kgne
饖	wpht
饗	xtye
饘	wpyg
饙	wpfm
饚	wpal
饛	wpae
饜	djee
饝	wpyd
饞	wpqy
饟	wpye
饠	wply
饡	wptm
饢	wpge
饣	qnb
饤	qnsh
饥	qnmn
饦	qnta
饧	qnnr
饨	qngn
饩	qnrn
饪	qntf
饫	qntd
饬	qntl
饭	qnrc
饮	qnqw
饯	qngt
饰	qnth
饱	qnqn
饲	qnnk
饳	qnbm
饴	qnck
饵	qnbg
饶	qnaq
饷	qntk
饸	qnwk
饹	qntk
饺	qnuq
饻	qnye
饼	qnua
饽	qnfb
饾	qngu
饿	qntt
馀	qnwt
馁	qnev
馂	qnct
馃	qnjs
馄	qnjx
馅	qnqv
馆	qnpn
馇	qnsg
馈	qnkm
馉	qnme
馊	qnvc
馋	qnqu
馌	qnfl
馍	qnad
馎	qngf
馏	qnql
馐	qnuf
馑	qnag
馒	qnjc
馓	qnat
馔	qnnw
馕	qnge
首	uthf
馗	vuth
馘	uthg
香	tjf
馚	tjwv
馛	tjdc
馜	tjnx
馝	tjnt
馞	tjfb
馟	tjeb
馠	tjwk
馡	tjdd
馢	tjaa
馣	tjdn
馤	tjjn
馥	tjtt
馦	tjuo
馧	tjjl
馨	fnmj
馩	tjfm
馪	tjpm
馫	tjtj
馬	cghy
馭	ccy
馮	ucy
馯	cfh
馰	cqyy
馱	cdy
馲	ctan
馳	cbn
馴	ckh
馵	caj
馶	cfcy
馷	cgmh
馸	crh
馹	cjg
馺	ceyy
馻	ccqn
馼	cyy
馽	ckhj
馾	cpqn
馿	cynt
駀	cdnn
駁	cqqy
駂	xfcy
駃	cnwy
駄	cdyy
駅	cnyy
駆	caqy
駇	cty
駈	crgg
駉	cmkg
駊	chcy
駋	cvkg
駌	qbcu
駍	cguh
駎	cmg
駏	cang
駐	cygg
駑	vccu
駒	cqkg
駓	cgig
駔	cegg
駕	lkcu
駖	cwyc
駗	cwet
駘	cckg
駙	cwfy
駚	cmdy
駛	ckqy
駜	cntt
駝	cpxn
駞	ctbn
駟	clg
駠	cqtb
駡	kkcu
駢	cuah
駣	ciqn
駤	cgcf
駥	cadt
駦	udcu
駧	cmgk
駨	cqjg
駩	cwgg
駪	ctfq
駫	ciqn
駬	cbg
駭	cynw
駮	cuqy
駯	criy
駰	cldy
駱	ctkg
駲	cyth
駳	cthp
駴	caah
駵	cgan
駶	cnnk
駷	cgki
駸	cvpc
駹	cdne
駺	cyve
駻	cjfh
駼	cwty
駽	ckeg
駾	cukq
駿	ccwt
騀	ctrt
騁	cmgn
騂	cuh
騃	cctd
騄	cviy
騅	cwyg
騆	cmfk
騇	cwfk
騈	ctff
騉	cjxx
騊	cqrm
騋	csww
騌	cpfi
騍	cjsy
騎	cdsk
騏	cadw
騐	cwyn
騑	cdjd
騒	ccjy
験	cwgw
騔	cjqn
騕	csvg
騖	cbtc
騗	ynmc
騘	cqrn
騙	cyna
騚	cuej
騛	cnuh
騜	crgg
騝	cvfp
騞	cdhd
騟	cwgj
騠	cjgh
騡	criy
騢	cnhc
騣	cqbt
騤	cwgd
騥	ccbs
騦	clny
騧	cmnk
騨	cijf
騩	crqc
騪	cvhc
騫	pfjc
騬	ctux
騭	bhic
騮	cqyl
騯	cupy
騰	eudc
騱	cexd
騲	cajh
騳	ccy
騴	cjpv
騵	cdri
騶	cqbt
騷	ccyj
騸	cynn
騹	cakg
騺	fufc
騻	cdqq
騼	cynx
騽	cnrg
騾	clxi
騿	cujh
驀	ajdc
驁	gqtc
驂	ccce
驃	csfi
驄	ctln
驅	cakk
驆	cjaf
驇	fwfc
驈	ccbk
驉	chag
驊	cagf
驋	cwxc
驌	cvfj
驍	cffq
驎	coqh
驏	cnbb
驐	cybt
驑	cgal
驒	ckkf
驓	culj
驔	csjh
驕	ctdk
驖	cfag
驗	cwgw
驘	ynky
驙	cylg
驚	aqkc
驛	clff
驜	cogw
驝	cfps
驞	cpgm
驟	cbci
驠	cauo
驡	uegc
驢	chal
驣	cudc
驤	cyke
驥	cuxw
驦	cfsh
驧	cafo
驨	cmwk
驩	caky
驪	cgmx
驫	cccu
马	cnng
驭	ccy
驮	cdy
驯	ckh
驰	cbn
驱	caqy
驲	cjg
驳	cqqy
驴	cynt
驵	cegg
驶	ckqy
驷	clg
驸	cwfy
驹	cqkg
驺	cqvg
驻	cygg
驼	cpxn
驽	vccf
驾	lkcf
驿	ccfh
骀	cckg
骁	catq
骂	kkcf
骃	cldy
骄	ctdj
骅	cwxf
骆	ctkg
骇	cynw
骈	cuah
骉	cccf
骊	cgmy
骋	cmgn
验	cwgi
骍	cuh
骎	cvpc
骏	ccwt
骐	cadw
骑	cdsk
骒	cjsy
骓	cwyg
骔	cpfi
骕	cvij
骖	ccde
骗	cyna
骘	bhic
骙	cwgd
骚	ccyj
骛	cbtc
骜	gqtc
骝	cqyl
骞	pfjc
骟	cynn
骠	csfi
骡	clxi
骢	ctln
骣	cnbb
骤	cbci
骥	cuxw
骦	cfsh
骧	cyke
骨	mef
骩	mevn
骪	memy
骫	mevy
骬	megf
骭	mefh
骮	meay
骯	meym
骰	memc
骱	mewj
骲	meqn
骳	mehc
骴	mehx
骵	mesg
骶	meqy
骷	medg
骸	meyw
骹	meuq
骺	merk
骻	medn
骼	metk
骽	meev
骾	megq
骿	meua
髀	merf
髁	mejs
髂	mepk
髃	mejy
髄	medp
髅	meov
髆	megf
髇	meyk
髈	meuy
髉	mepy
髊	meua
髋	mepq
髌	mepw
髍	meys
髎	mene
髏	melv
髐	mefq
髑	melj
髒	meaa
髓	medp
體	memu
髕	mepm
髖	mepy
髗	mehl
高	ymkf
髙	yjfk
髚	ymkm
髛	ymkv
髜	ymka
髝	ymkl
髞	ymks
髟	det
髠	demb
髡	degq
髢	debb
髣	deyb
髤	desu
髥	demf
髦	detn
髧	depq
髨	defq
髩	degn
髪	dedc
髫	devk
髬	degg
髭	dehx
髮	dedc
髯	demf
髰	dean
髱	deqn
髲	dehc
髳	dect
髴	dexj
髵	dedj
髶	debf
髷	dema
髸	deaw
髹	dews
髺	detd
髻	defk
髼	deth
髽	dewf
髾	deie
髿	deit
鬀	deut
鬁	detj
鬂	derw
鬃	depi
鬄	dejr
鬅	deee
鬆	desc
鬇	deqh
鬈	deub
鬉	deqt
鬊	dedj
鬋	deuj
鬌	dede
鬍	dede
鬎	degj
鬏	deto
鬐	defj
鬑	deuo
鬒	defw
鬓	depw
鬔	detp
鬕	dead
鬖	dece
鬗	deay
鬘	dejc
鬙	deuj
鬚	deem
鬛	deln
鬜	deue
鬝	deuj
鬞	deme
鬟	dele
鬠	dewj
鬡	deps
鬢	depm
鬣	devn
鬤	deye
鬥	hggh
鬦	hggf
鬧	hggh
鬨	hggw
鬩	hggq
鬪	hggf
鬫	hggt
鬬	hggr
鬭	hggr
鬮	hggx
鬯	qobx
鬰	sqqe
鬱	srme
鬲	gkmh
鬳	hagh
鬴	gkmy
鬵	aqah
鬶	fwmh
鬷	gkmt
鬸	gkml
鬹	fwhh
鬺	gkmr
鬻	xoxh
鬼	rqci
鬽	rqce
鬾	rqcc
鬿	rqcr
魀	rqcj
魁	rqcf
魂	fcrc
魃	rqcc
魄	rrqc
魅	rqci
魆	rqct
魇	ddrc
魈	rqce
魉	rqcw
魊	rqcg
魋	rqcy
魌	rqcw
魍	rqcn
魎	rqcy
魏	tvrc
魐	rqco
魑	rqcc
魒	rqci
魓	rqcf
魔	yssc
魕	rqcw
魖	rqcg
魗	fnac
魘	djec
魙	ilrc
魚	qou
魛	qovn
魜	qowy
魝	qojh
魞	qoty
魟	qoag
魠	qota
魡	qoqy
魢	qonn
魣	qocb
魤	qowx
魥	qoey
魦	qoit
魧	qoym
魨	qogn
魩	qoqr
魪	qowj
魫	jvtk
魬	qorc
魭	qofq
魮	qoxx
魯	qojf
魰	qoyy
魱	qogg
魲	qoyn
魳	qogh
魴	qoyn
魵	qowv
魶	qomw
魷	qodn
魸	qotn
魹	qotn
魺	qosk
魻	qolh
魼	qofc
魽	qoaf
魾	qogg
魿	qowc
鮀	qopx
鮁	qodc
鮂	qolw
鮃	qogh
鮄	qoxj
鮅	qont
鮆	hxqo
鮇	qofi
鮈	qoqk
鮉	qovk
鮊	qorg
鮋	qomg
鮌	qoyx
鮍	qohc
鮎	qohk
鮏	qotg
鮐	qock
鮑	qoqn
鮒	qowf
鮓	qotf
鮔	qoan
鮕	qodg
鮖	qodg
鮗	qotu
鮘	qowa
鮙	qong
鮚	qofk
鮛	qohi
鮜	qork
鮝	udqo
鮞	qodj
鮟	qopv
鮠	qoqb
鮡	qoiq
鮢	qori
鮣	qoqb
鮤	gqjo
鮥	qotk
鮦	qomk
鮧	qogw
鮨	qoxj
鮩	qoua
鮪	qode
鮫	qouq
鮬	qodn
鮭	qoff
鮮	qoud
鮯	qowk
鮰	qolk
鮱	qofx
鮲	qowd
鮳	qofn
鮴	qows
鮵	qouq
鮶	qovk
鮷	qout
鮸	qoqq
鮹	qoie
鮺	udqo
鮻	qoct
鮼	qovc
鮽	qowt
鮾	qoev
鮿	qobn
鯀	qoti
鯁	qogq
鯂	qosg
鯃	qogk
鯄	qofy
鯅	qotp
鯆	qogy
鯇	qopq
鯈	whto
鯉	qojf
鯊	iito
鯋	qoit
鯌	qotk
鯍	qoyq
鯎	qodt
鯏	qotj
鯐	qofh
鯑	qoqh
鯒	qoce
鯓	qott
鯔	qovl
鯕	qoaw
鯖	qoge
鯗	udyo
鯘	qotv
鯙	qoyb
鯚	qotb
鯛	qomk
鯜	qouv
鯝	qold
鯞	qovh
鯟	qogi
鯠	qosw
鯡	qodd
鯢	qovq
鯣	qojr
鯤	qojx
鯥	qoff
鯦	qotk
鯧	qojj
鯨	qoyi
鯩	qowa
鯪	qoft
鯫	qobc
鯬	tqto
鯭	qobl
鯮	qopi
鯯	qorj
鯰	qown
鯱	qohm
鯲	qoyu
鯳	qoyy
鯴	qonj
鯵	qoce
鯶	qopl
鯷	qojh
鯸	qowd
鯹	qojg
鯺	qofj
鯻	qogj
鯼	qoqt
鯽	qovb
鯾	qowq
鯿	qoya
鰀	qoec
鰁	qori
鰂	qomj
鰃	qole
鰄	qodt
鰅	qojy
鰆	qodj
鰇	qocs
鰈	qoas
鰉	qorg
鰊	qogi
鰋	qoav
鰌	qoug
鰍	qoto
鰎	qovp
鰏	qogl
鰐	qokn
鰑	qojr
鰒	qott
鰓	qoln
鰔	qodt
鰕	qonc
鰖	qode
鰗	qode
鰘	qopf
鰙	qoak
鰚	qopg
鰛	qojl
鰜	qouo
鰝	qoyk
鰞	qowo
鰟	qouy
鰠	qocj
鰡	qoql
鰢	qocy
鰣	qojf
鰤	qowh
鰥	qoli
鰦	qoux
鰧	eudo
鰨	qojn
鰩	qoem
鰪	qofl
鰫	qopk
鰬	qohy
鰭	qofj
鰮	qoll
鰯	qoxu
鰰	qoph
鰱	qolp
鰲	gqto
鰳	qoal
鰴	qomt
鰵	txgo
鰶	qowi
鰷	qows
鰸	qoak
鰹	qoaf
鰺	qoce
鰻	qojc
鰼	qonr
鰽	qogj
鰾	qosi
鰿	qogm
鱀	vcao
鱁	qoep
鱂	qonf
鱃	qouf
鱄	qogf
鱅	qoyh
鱆	qouj
鱇	qoyi
鱈	qofv
鱉	umio
鱊	qock
鱋	qohg
鱌	qoqe
鱍	qowc
鱎	qotk
鱏	qosj
鱐	qovj
鱑	qoaw
鱒	qouf
鱓	qokf
鱔	qouk
鱕	qotl
鱖	qodw
鱗	qooh
鱘	qovf
鱙	qofq
鱚	qofk
鱛	qouj
鱜	qoxb
鱝	qofm
鱞	qole
鱟	wfqo
鱠	qowj
鱡	qomd
鱢	qoks
鱣	qoyg
鱤	qodn
鱥	qoht
鱦	qoxg
鱧	qomu
鱨	qoij
鱩	qofl
鱪	qojj
鱫	qoet
鱬	qofj
鱭	qoyj
鱮	qoww
鱯	qoac
鱰	qolj
鱱	qody
鱲	qovn
鱳	qoxs
鱴	qoat
鱵	qott
鱶	qoue
鱷	qogk
鱸	qohl
鱹	qoay
鱺	qogx
鱻	qoqo
鱼	qgf
鱽	qgvn
鱾	qgnn
鱿	qgdn
鲀	qggn
鲁	qgjf
鲂	qgyn
鲃	qgcn
鲄	qgsk
鲅	qgdc
鲆	qggh
鲇	qghk
鲈	qghn
鲉	qgmg
鲊	qgtf
鲋	qgwf
鲌	qgrg
鲍	qgqn
鲎	ipqg
鲏	qghc
鲐	qgck
鲑	qgff
鲒	qgfk
鲓	qgfn
鲔	qgde
鲕	qgdj
鲖	qgmk
鲗	qgmj
鲘	qgrk
鲙	qgwc
鲚	qgyj
鲛	qguq
鲜	qgud
鲝	udqg
鲞	udqg
鲟	qgvf
鲠	qggq
鲡	qggy
鲢	qglp
鲣	qgjf
鲤	qgjf
鲥	qgjf
鲦	qgts
鲧	qgti
鲨	iitg
鲩	qgpq
鲪	qgvk
鲫	qgvb
鲬	qgce
鲭	qgge
鲮	qgft
鲯	qgaw
鲰	qgbc
鲱	qgdd
鲲	qgjx
鲳	qgjj
鲴	qgld
鲵	qgvq
鲶	qgwn
鲷	qgmk
鲸	qgyi
鲹	qgce
鲺	qgnj
鲻	qgvl
鲼	qgfm
鲽	qgas
鲾	qggl
鲿	qgic
鳀	qgjh
鳁	qgjl
鳂	qgle
鳃	qgln
鳄	qgkn
鳅	qgto
鳆	qgtt
鳇	qgrg
鳈	qgri
鳉	qguf
鳊	qgya
鳋	qgcj
鳌	gqtg
鳍	qgfj
鳎	qgjn
鳏	qgli
鳐	qgem
鳑	qguy
鳒	qguo
鳓	qgal
鳔	qgsi
鳕	qgfv
鳖	umig
鳗	qgjc
鳘	txgg
鳙	qgyh
鳚	qgnf
鳛	qgnr
鳜	qgdw
鳝	qguk
鳞	qgoh
鳟	qguf
鳠	qgac
鳡	qgdn
鳢	qgmu
鳣	qgyg
鳤	qgtn
鳥	wvgo
鳦	wvgn
鳧	wvgm
鳨	wvgl
鳩	vwvo
鳪	hwvo
鳫	dwvo
鳬	wvgm
鳭	vwvo
鳮	cwvo
鳯	mwvo
鳰	tywo
鳱	fwvo
鳲	nwvo
鳳	mgwo
鳴	kwvo
鳵	nfwo
鳶	awvo
鳷	fcwo
鳸	ynwo
鳹	wyno
鳺	fwwo
鳻	wvwo
鳼	ywvo
鳽	gawo
鳾	gmho
鳿	gwvo
鴀	giwo
鴁	tdwo
鴂	nwwo
鴃	wvgw
鴄	aqwo
鴅	mywo
鴆	pqwo
鴇	xfwo
鴈	dwwo
鴉	ahto
鴊	ghwo
鴋	ywvo
鴌	gdwo
鴍	ywvo
鴎	aqwo
鴏	wvga
鴐	lkwo
鴑	vcwo
鴒	wyco
鴓	ntwo
鴔	tpwo
鴕	wvgx
鴖	nawo
鴗	uwvo
鴘	cawo
鴙	tdwo
鴚	wvgk
鴛	qbwo
鴜	hxwo
鴝	qkwo
鴞	kgno
鴟	qayo
鴠	jgwo
鴡	egwo
鴢	xlwo
鴣	dwvo
鴤	wvgu
鴥	wvgw
鴦	mdwo
鴧	pmwo
鴨	lwvo
鴩	rwwo
鴪	pwwo
鴫	lwvo
鴬	ipwo
鴭	wnno
鴮	dfno
鴯	dmjo
鴰	tdwo
鴱	aqwo
鴲	xjwo
鴳	pvwo
鴴	tfho
鴵	iqwo
鴶	fkwo
鴷	gqjo
鴸	riwo
鴹	udwo
鴺	gxwo
鴻	iawo
鴼	wvgk
鴽	vkwo
鴾	crho
鴿	wgko
鵀	wtfo
鵁	uqwo
鵂	wswo
鵃	tewo
鵄	gcfo
鵅	tkwo
鵆	twvh
鵇	rhfo
鵈	bwvo
鵉	yowo
鵊	dwwo
鵋	nnwo
鵌	wvgt
鵍	pfqo
鵎	evwo
鵏	geho
鵐	awwo
鵑	kewo
鵒	wwko
鵓	fpbo
鵔	wvgt
鵕	cwto
鵖	vcwo
鵗	qdmo
鵘	vtko
鵙	mwvo
鵚	tmwo
鵛	gvao
鵜	uxho
鵝	trno
鵞	trno
鵟	qtgo
鵠	tfko
鵡	gaho
鵢	tmdo
鵣	gkio
鵤	qewo
鵥	udjo
鵦	wvgi
鵧	uawo
鵨	wfko
鵩	ebco
鵪	djno
鵫	hjwo
鵬	eewo
鵭	qwvo
鵮	qvwo
鵯	rtfo
鵰	mfko
鵱	fwfo
鵲	ajwo
鵳	yneo
鵴	qowo
鵵	qkqo
鵶	gfgo
鵷	pqbo
鵸	dsko
鵹	tqto
鵺	ywto
鵻	wvgy
鵼	pwao
鵽	ccco
鵾	jxxo
鵿	wvga
鶀	wvgw
鶁	yiwo
鶂	vqwo
鶃	wvgq
鶄	gewo
鶅	vlwo
鶆	swwo
鶇	gjio
鶈	gvho
鶉	ybwo
鶊	yvwo
鶋	ndwo
鶌	nbmo
鶍	jqro
鶎	pfio
鶏	efwo
鶐	sypo
鶑	oowo
鶒	gkio
鶓	alwo
鶔	cbto
鶕	ujwo
鶖	towo
鶗	jgho
鶘	dewo
鶙	upmo
鶚	kkfo
鶛	xxro
鶜	acbo
鶝	gklo
鶞	rfho
鶟	pwdo
鶠	ajvo
鶡	jqwo
鶢	efto
鶣	ynmo
鶤	plwo
鶥	nhwo
鶦	dewo
鶧	amdo
鶨	xewo
鶩	cbto
鶪	hdwo
鶫	glio
鶬	wyvo
鶭	xywo
鶮	ymko
鶯	oopo
鶰	kmwo
鶱	pfjo
鶲	wcno
鶳	wvgh
鶴	pwyo
鶵	qbto
鶶	yvho
鶷	pdho
鶸	xuxo
鶹	qyvo
鶺	iweo
鶻	mewo
鶼	uvoo
鶽	wyfo
鶾	fjwo
鶿	uxxo
鷀	uxxo
鷁	uwlo
鷂	ermo
鷃	jpvo
鷄	exdo
鷅	sswo
鷆	xhno
鷇	fpgc
鷈	wvgm
鷉	rhao
鷊	gkmo
鷋	awto
鷌	wvgc
鷍	thso
鷎	rdfo
鷏	fhwo
鷐	jdfo
鷑	tuwo
鷒	gjho
鷓	yaoo
鷔	gqto
鷕	kwyo
鷖	atdo
鷗	akko
鷘	gkio
鷙	fufo
鷚	nweo
鷛	yveo
鷜	lvwo
鷝	jafo
鷞	dqqo
鷟	ytto
鷠	qowo
鷡	rlgo
鷢	dubo
鷣	sjwo
鷤	kkjo
鷥	xxio
鷦	wyoo
鷧	fpgo
鷨	agao
鷩	umio
鷪	hhpo
鷫	vfjo
鷬	amwo
鷭	tolo
鷮	tdko
鷯	dujo
鷰	auko
鷱	thio
鷲	yido
鷳	uewo
鷴	uswo
鷵	nfto
鷶	lmwo
鷷	usgo
鷸	cbto
鷹	ywwo
鷺	khto
鷻	wvgt
鷼	ujwo
鷽	wfqo
鷾	ujno
鷿	nkuo
鸀	lqjo
鸁	ynky
鸂	iexo
鸃	wvgt
鸄	ryto
鸅	lfuo
鸆	hako
鸇	ylko
鸈	oguo
鸉	sjgo
鸊	nkuo
鸋	pnlo
鸌	wvgc
鸍	gwmo
鸎	mmwo
鸏	apgo
鸐	nwyo
鸑	qtyo
鸒	wfgo
鸓	lllo
鸔	wvgi
鸕	halo
鸖	fwyo
鸗	uego
鸘	fsho
鸙	wgko
鸚	mmvo
鸛	akko
鸜	hhwo
鸝	gmyo
鸞	xyxo
鸟	qyng
鸠	vqyg
鸡	cqyg
鸢	aqyg
鸣	kqyg
鸤	nqyg
鸥	aqqg
鸦	ahtg
鸧	wbqg
鸨	xfqg
鸩	pqqg
鸪	dqyg
鸫	aiqg
鸬	hnqg
鸭	lqyg
鸮	kgng
鸯	mdqg
鸰	wycg
鸱	qayg
鸲	qkqg
鸳	qbqg
鸴	ipqg
鸵	qynx
鸶	xxgg
鸷	rvyg
鸸	dmjg
鸹	tdqg
鸺	wsqg
鸻	tfhg
鸼	teqg
鸽	wgkg
鸾	yoqg
鸿	iaqg
鹀	awwg
鹁	fpbg
鹂	gmyg
鹃	keqg
鹄	tfkg
鹅	trng
鹆	wwkg
鹇	usqg
鹈	uxhg
鹉	gahg
鹊	ajqg
鹋	alqg
鹌	djng
鹍	jxxg
鹎	rtfg
鹏	eeqg
鹐	qvqg
鹑	ybqg
鹒	yvwg
鹓	pqbg
鹔	vijg
鹕	deqg
鹖	jqwg
鹗	kkfg
鹘	meqg
鹙	toqg
鹚	uxxg
鹛	nhqg
鹜	cbtg
鹝	gkmg
鹞	ermg
鹟	wcng
鹠	qyvg
鹡	iweg
鹢	uwlg
鹣	uvog
鹤	pwyg
鹥	atdg
鹦	mmvg
鹧	yaog
鹨	nweg
鹩	dujg
鹪	wyog
鹫	yidg
鹬	cbtg
鹭	khtg
鹮	lgkg
鹯	ylkg
鹰	ywwg
鹱	qync
鹲	apgg
鹳	akkg
鹴	fshg
鹵	hlqo
鹶	hlqn
鹷	hlqc
鹸	hlqw
鹹	hlqt
鹺	hlqa
鹻	hlqo
鹼	hlqw
鹽	ahnl
鹾	hlqa
鹿	ynjx
麀	ynjx
麁	qynx
麂	ynjm
麃	ynjo
麄	wvyx
麅	ynjn
麆	ynjg
麇	ynjt
麈	ynjg
麉	ffyx
麊	oynx
麋	ynjo
麌	ynjd
麍	ynjq
麎	ynje
麏	ynjk
麐	ynjk
麑	ynjq
麒	ynjw
麓	ssyx
麔	ynjk
麕	ynjt
麖	ynji
麗	gmyx
麘	ynjj
麙	ynjt
麚	ynjc
麛	ynjb
麜	ynjs
麝	ynjf
麞	ynjj
麟	ynjh
麠	ynjg
麡	ynjj
麢	ynjk
麣	ynjt
麤	ynjx
麥	swwt
麦	gtu
麧	swwn
麨	swwt
麩	swww
麪	swwn
麫	swwn
麬	swwc
麭	swwn
麮	swwc
麯	swwa
麰	swwh
麱	swwy
麲	swwq
麳	swww
麴	swwo
麵	swwd
麶	swwc
麷	swwu
麸	gtfw
麹	gtqo
麺	gtdd
麻	yssi
麼	yssx
麽	yssc
麾	yssn
麿	yssk
黀	yssc
黁	yssj
黂	yssm
黃	agmw
黄	amwu
黅	amwn
黆	amwq
黇	amwk
黈	amwg
黉	ipaw
黊	amwf
黋	iqaw
黌	wfqw
黍	twiu
黎	tqti
黏	twik
黐	twic
黑	lfou
黒	jfou
黓	lfoa
黔	lfon
黕	lfoq
黖	lfoq
黗	lfon
默	lfod
黙	jfdo
黚	lfof
黛	walo
黜	lfom
黝	lfol
點	lfok
黟	lfoq
黠	lfok
黡	ddlo
黢	lfot
黣	lfou
黤	lfon
黥	lfoi
黦	lfob
黧	tqto
黨	ipko
黩	lfod
黪	lfoe
黫	lfof
黬	lfot
黭	lfoa
黮	lfon
黯	lfoj
黰	lfow
黱	eudo
黲	lfoe
黳	atdo
黴	tmgt
黵	lfoy
黶	djeo
黷	lfom
黸	lfol
黹	ogui
黺	oguv
黻	oguc
黼	oguy
黽	xhng
黾	kjnb
黿	fqxf
鼀	fwxf
鼁	fcxf
鼂	jgxf
鼃	ffxf
鼄	rixf
鼅	tdkx
鼆	pjux
鼇	gqtx
鼈	umix
鼉	kklx
鼊	nkux
鼋	fqkn
鼌	jgkn
鼍	kkln
鼎	hndn
鼏	phnn
鼐	ehnn
鼑	hhnn
鼒	fthn
鼓	fkuc
鼔	fkuc
鼕	fkuu
鼖	fafc
鼗	iqfc
鼘	fkug
鼙	fkuf
鼚	fkue
鼛	fkuk
鼜	fkuj
鼝	ijgc
鼞	fkuf
鼟	fkuu
鼠	vnun
鼡	imfh
鼢	vnuv
鼣	vnud
鼤	vnuy
鼥	vnuc
鼦	vnuk
鼧	vnux
鼨	vnuu
鼩	vnuk
鼪	vnug
鼫	vnud
鼬	vnum
鼭	vnuf
鼮	vnup
鼯	vnuk
鼰	vnum
鼱	vnue
鼲	vnul
鼳	vnud
鼴	vnuv
鼵	vnud
鼶	vnum
鼷	vnud
鼸	vnuo
鼹	vnuv
鼺	vnul
鼻	thlj
鼼	thlh
鼽	thlv
鼾	thlf
鼿	thlq
齀	thln
齁	thlk
齂	thli
齃	thln
齄	thlg
齅	thld
齆	thlc
齇	thlg
齈	thle
齉	thle
齊	yjf
齋	yjiu
齌	yjou
齍	yjlf
齎	yjmu
齏	yjdg
齐	yjj
齑	ydjj
齒	hbj
齓	hbnn
齔	hbxn
齕	hbtn
齖	hbat
齗	hbrh
齘	hbwj
齙	hbqn
齚	hbtf
齛	hban
齜	hbhx
齝	hbck
齞	hbkw
齟	hbeg
齠	hbvk
齡	hbwc
齢	hobc
齣	hbqk
齤	udhb
齥	hbjx
齦	hbve
齧	dhvb
齨	hbvg
齩	hbuq
齪	hbkh
齫	hbls
齬	hbgk
齭	hbrr
齮	hbdk
齯	hbvq
齰	hbaj
齱	hbbc
齲	hbty
齳	hbpl
齴	hbue
齵	hbjy
齶	hbkn
齷	hbnf
齸	hbul
齹	udab
齺	hbqt
齻	hbfw
齼	hbsh
齽	hbsi
齾	hagb
齿	hwbj
龀	hwbx
龁	hwbn
龂	hwbr
龃	hwbg
龄	hwbc
龅	hwbn
龆	hwbk
龇	hwbx
龈	hwbe
龉	hwbk
龊	hwbh
龋	hwby
龌	hwbf
龍	uegd
龎	dued
龏	uega
龐	yued
龑	uegd
龒	uegi
龓	deud
龔	uegw
龕	wgkd
龖	uegd
龗	fkkd
龘	uegd
龙	dxv
龚	dxaw
龛	wgkx
龜	txd
龝	ttxg
龞	umix
龟	qjnb
龠	wgka
龡	wgkw
龢	wgkt
龣	wgki
龤	wgkr
龥	wgkm
龦	oiph
龧	jjfj
龨	awyd
龩	aafr
龪	fhwi
龫	lwfh
龬	qmun
龭	claw
龮	cnlw
龯	qdnt
龰	hhgy
龱	lqi
龲	qylh
龳	fqff
龴	cny
龵	rtgt
龶	gghg
龷	aghg
龸	ipb
龹	ufw
龺	fjh
龻	xyxy
龼	fhph
龽	oqoy
龾	hcqo
龿	awff
鿀	aatg
鿁	yawy
鿂	lwvo
鿃	hdty
鿄	ivys
鿅	pyfb
鿆	pydc
鿇	wqvh
鿈	tnyy
鿉	tgg
鿊	aihf
鿋	pufk
鿌	iyji
鿍	ftah
鿎	ddpy
鿏	qgty
鿐	qoig
鿑	ugyy
鿒	admu
鿓	admu
鿔	qskk
鿕	qgmy
鿖	wgkg
鿗	wwvg
鿘	wvtk
鿙	wvtq
鿚	wvtk
鿛	ufwq
鿜	rugq
鿝	slyq
鿞	gqjq
鿟	tjqi
鿠	tjgq
鿡	lxwq
鿢	bbwk
鿣	bbdq
鿤	bbsk
鿥	yvcq
鿦	amdt
鿧	btgq
鿨	flgq
鿩	qojq
鿪	weyo
鿫	rntd
鿬	dlg
鿭	qqiy
鿮	yahh
鿯	trqo
